14 12
87 0 0 0 0 87 0 0 0 0 87 0 0 0 0 87 0 0 0 0 87 0 0 0 0 87 0 0 0 0 87 0 0 0 0 87 0 0 0 0 87 0 0 0 0 87 0 0 0 0 87 0 0 0 0 87 0 0 0 0 87 0 0 0 0 87 0 0 0 0 
87 0 0 0 0 87 0 0 0 0 87 0 0 0 0 87 0 0 0 0 87 0 0 0 0 87 0 0 0 0 87 0 0 0 0 87 0 0 0 0 87 0 0 0 0 87 0 0 0 0 87 0 0 0 0 332 0 0 0 0 87 0 0 0 0 87 0 0 0 0 
338 0 0 0 0 87 0 0 0 0 87 0 0 0 0 87 0 0 0 0 87 0 0 0 0 87 0 0 0 0 87 0 0 0 0 87 0 0 0 0 87 0 0 0 0 87 0 0 0 0 87 0 0 0 0 87 0 0 0 0 87 0 0 0 0 87 0 0 0 0 
87 0 0 0 0 87 0 0 0 0 87 0 0 0 0 87 0 0 0 0 87 0 0 0 0 332 0 0 0 0 87 0 0 0 0 87 0 0 0 0 87 0 0 0 0 87 0 0 0 0 87 0 0 0 0 87 0 0 0 0 87 0 0 0 0 87 0 0 0 0 
87 0 0 0 0 87 0 0 0 0 87 0 0 0 0 87 0 0 0 0 87 0 0 0 0 96 0 0 0 0 96 0 0 0 0 96 0 0 0 0 87 0 0 0 0 87 0 0 0 0 87 0 0 0 0 87 0 0 0 0 87 0 0 0 0 87 0 0 0 0 
87 0 0 0 0 87 0 0 0 0 87 0 0 0 0 347 0 0 0 0 87 0 0 0 0 96 0 0 0 0 96 0 0 0 0 96 0 0 0 0 96 0 0 0 0 96 0 0 0 0 87 0 0 0 0 87 0 0 0 0 87 0 0 0 0 87 0 0 0 0 
87 0 0 0 0 87 0 0 0 0 87 0 0 0 0 87 0 0 0 0 87 0 0 0 0 98 0 0 0 0 96 0 0 0 0 96 0 0 0 0 96 0 0 0 0 96 0 0 0 0 87 0 0 0 0 332 0 0 0 0 87 0 0 0 0 87 0 0 0 0 
87 0 0 0 0 87 0 0 0 0 87 0 0 0 0 87 0 0 0 0 87 0 0 0 0 87 0 0 0 0 96 0 0 0 0 96 0 0 0 0 96 0 0 0 0 98 0 0 0 0 87 0 0 0 0 87 0 0 0 0 87 0 0 0 0 87 0 0 0 0 
87 0 0 0 0 87 0 0 0 0 87 0 0 0 0 87 0 0 0 0 339 0 0 0 0 87 0 0 0 0 98 0 0 0 0 98 0 0 0 0 98 0 0 0 0 87 0 0 0 0 87 0 0 0 0 87 0 0 0 0 87 0 0 0 0 87 0 0 0 0 
87 0 0 0 0 87 0 0 0 0 87 0 0 0 0 87 0 0 0 0 87 0 0 0 0 87 0 0 0 0 87 0 0 0 0 87 0 0 0 0 87 0 0 0 0 87 0 0 0 0 87 0 0 0 0 87 0 0 0 0 87 0 0 0 0 87 0 0 0 0 
87 0 0 0 0 87 0 0 0 0 87 0 0 0 0 87 0 0 0 0 87 0 0 0 0 87 0 0 0 0 87 0 0 0 0 87 0 0 0 0 87 0 0 0 0 87 0 0 0 0 87 0 0 0 0 329 0 0 0 0 87 0 0 0 0 87 0 0 0 0 
87 0 0 0 0 87 0 0 0 0 87 0 0 0 0 87 0 0 0 0 87 0 0 0 0 87 0 0 0 0 87 0 0 0 0 87 0 0 0 0 87 0 0 0 0 87 0 0 0 0 87 0 0 0 0 87 0 0 0 0 87 0 0 0 0 87 0 0 0 0 