15 15
91 0 0 1 0 88 0 0 1 0 88 0 0 1 0 88 0 0 1 0 88 0 0 1 0 88 0 0 1 0 88 0 0 1 0 88 0 0 1 0 88 0 0 1 0 88 0 0 1 0 88 0 0 1 0 88 0 0 1 0 88 0 0 1 0 88 0 0 1 0 91 0 0 1 0 
90 0 0 1 0 96 141 0 1 0 96 142 0 1 0 96 142 0 1 0 96 142 0 1 0 96 142 0 1 0 96 0 0 0 0 96 0 0 0 0 96 0 0 0 0 96 0 0 0 0 96 0 0 0 0 96 0 0 0 0 96 134 0 1 0 96 134 0 1 0 90 0 0 1 0 
90 0 0 1 0 96 142 0 1 0 125 142 0 1 0 125 141 0 1 0 125 114 0 1 0 125 0 0 0 0 125 130 0 1 0 125 0 0 0 0 125 130 0 1 0 125 0 0 0 0 125 114 0 1 0 125 0 0 0 0 125 0 0 0 0 96 134 0 1 0 90 0 0 1 0 
90 0 0 1 0 96 142 0 1 0 125 141 0 1 0 125 141 0 1 0 125 142 0 1 0 125 0 0 0 0 125 0 0 0 0 125 0 0 0 0 125 0 0 0 0 125 0 0 0 0 125 0 0 0 0 125 0 0 0 0 125 0 0 0 0 96 0 0 0 0 90 0 0 1 0 
90 0 0 1 0 96 142 0 1 0 96 142 0 1 0 96 142 0 1 0 96 142 0 1 0 96 141 0 1 0 96 71 0 1 0 96 69 0 0 0 96 72 0 0 0 96 0 0 0 0 96 0 0 0 0 96 0 0 0 0 96 0 0 0 0 96 0 0 0 0 90 0 0 1 0 
90 0 0 1 0 96 142 0 1 0 125 141 0 1 0 125 142 0 1 0 125 0 0 0 0 125 0 0 0 0 125 69 0 0 0 125 69 0 0 0 125 69 0 0 0 125 0 0 0 0 125 0 0 0 0 125 0 0 0 0 125 0 0 0 0 96 134 0 1 0 90 0 0 1 0 
90 0 0 1 0 96 142 0 1 0 125 0 0 0 0 125 0 0 0 0 125 141 0 1 0 125 0 0 0 0 125 69 0 0 0 125 69 0 0 0 125 69 0 0 0 125 0 0 0 0 125 0 0 0 0 125 0 0 0 0 125 0 0 0 0 96 0 0 0 0 90 0 0 1 0 
90 0 0 1 0 96 0 0 0 0 96 141 0 1 0 96 0 0 0 0 96 0 0 0 0 96 0 0 0 0 96 73 0 0 0 96 69 0 0 0 96 74 0 0 0 96 0 0 0 0 96 0 0 0 0 96 0 0 0 0 96 0 0 0 0 96 0 0 0 0 90 0 0 1 0 
90 0 0 1 0 96 0 0 0 0 125 0 0 0 0 125 0 0 0 0 125 0 0 0 0 125 0 0 0 0 125 0 0 0 0 125 0 0 0 0 125 0 0 0 0 125 0 0 0 0 125 0 0 0 0 125 0 0 0 0 125 0 0 0 0 96 0 0 0 0 90 0 0 1 0 
90 0 0 1 0 96 0 0 0 0 125 0 0 0 0 125 0 0 0 0 125 0 0 0 0 125 0 0 0 0 125 0 0 0 0 125 0 0 0 0 125 0 0 0 0 125 0 0 0 0 125 0 0 0 0 125 0 0 0 0 125 0 0 0 0 96 134 0 1 0 90 0 0 1 0 
90 0 0 1 0 96 0 0 0 0 96 0 0 0 0 96 0 0 0 0 96 0 0 0 0 96 0 0 0 0 96 0 0 0 0 96 0 0 0 0 96 0 0 0 0 96 0 0 0 0 96 0 0 0 0 96 0 0 0 0 96 0 0 0 0 96 0 0 0 0 90 0 0 1 0 
90 0 0 1 0 96 0 0 0 0 125 0 0 0 0 125 0 0 0 0 125 0 0 0 0 125 0 0 0 0 125 0 0 0 0 125 0 0 0 0 125 0 0 0 0 125 0 0 0 0 125 0 0 0 0 125 0 0 0 0 125 0 0 0 0 96 0 0 0 0 90 0 0 1 0 
90 0 0 1 0 96 0 0 0 0 125 0 0 0 0 125 0 0 0 0 125 0 0 0 0 125 0 0 0 0 125 0 0 0 0 125 0 0 0 0 125 0 0 0 0 125 0 0 0 0 125 0 0 0 0 125 0 0 0 0 125 0 0 0 0 96 0 0 0 0 90 0 0 1 0 
90 0 0 1 0 96 0 0 0 0 96 0 0 0 0 96 0 0 0 0 96 0 0 0 0 96 0 0 0 0 96 0 0 0 0 96 0 0 0 0 96 0 0 0 0 96 0 0 0 0 96 0 0 0 0 96 0 0 0 0 96 0 0 0 0 96 0 0 0 0 90 0 0 1 0 
89 0 0 1 0 88 0 0 1 0 88 0 0 1 0 88 0 0 1 0 88 0 0 1 0 88 0 0 1 0 88 0 0 1 0 88 0 0 1 0 96 118 0 0 0 88 0 0 1 0 88 0 0 1 0 88 0 0 1 0 88 0 0 1 0 88 0 0 1 0 89 0 0 1 0 