14 12
91 0 0 1 0 88 0 0 1 0 88 0 0 1 0 88 0 0 1 0 88 0 0 1 0 88 0 0 1 0 88 0 0 1 0 88 0 0 1 0 88 0 0 1 0 88 0 0 1 0 88 0 0 1 0 88 0 0 1 0 88 0 0 1 0 91 0 0 1 0 
90 0 0 1 0 96 134 0 1 0 96 114 0 1 0 96 0 0 0 0 96 0 0 0 0 96 114 0 1 0 96 0 0 0 0 96 0 0 0 0 96 114 0 1 0 96 0 0 0 0 96 117 0 1 0 96 114 0 1 0 96 117 0 1 0 90 0 0 1 0 
90 0 0 1 0 96 134 0 1 0 96 0 0 0 0 96 178 0 1 0 96 178 0 1 0 96 133 0 1 0 96 178 0 1 0 96 178 0 1 0 96 132 0 1 0 96 178 0 1 0 96 178 0 1 0 96 132 0 1 0 96 0 0 0 0 90 0 0 1 0 
90 0 0 1 0 96 134 0 1 0 96 0 0 0 0 96 0 0 0 0 96 117 0 1 0 96 0 0 0 0 96 0 0 0 0 96 0 0 0 0 96 0 0 0 0 96 0 0 0 0 96 0 0 0 0 96 0 0 0 0 96 0 0 0 0 90 0 0 1 0 
90 0 0 1 0 96 0 0 0 0 96 0 0 0 0 96 0 0 0 0 96 0 0 0 0 96 0 0 0 0 96 0 0 0 0 96 0 0 0 0 96 0 0 0 0 96 0 0 0 0 96 0 0 0 0 96 0 0 0 0 96 0 0 0 0 90 0 0 1 0 
90 0 0 1 0 96 0 0 0 0 96 0 0 0 0 96 0 0 0 0 96 0 0 0 0 96 0 0 0 0 96 0 0 0 0 96 0 0 0 0 96 0 0 0 0 96 0 0 0 0 96 0 0 0 0 96 0 0 0 0 96 0 0 0 0 90 0 0 1 0 
90 0 0 1 0 96 0 0 0 0 96 117 0 1 0 96 0 0 0 0 96 0 0 0 0 96 0 0 0 0 96 0 0 0 0 96 0 0 0 0 96 0 0 0 0 96 0 0 0 0 96 0 0 0 0 96 0 0 0 0 96 133 0 1 0 90 0 0 1 0 
90 0 0 1 0 96 0 0 0 0 96 0 0 0 0 96 0 0 0 0 96 0 0 0 0 96 0 0 0 0 96 0 0 0 0 96 0 0 0 0 96 0 0 0 0 96 0 0 0 0 96 0 0 0 0 96 0 0 0 0 96 0 0 0 0 90 0 0 1 0 
90 0 0 1 0 96 0 0 0 0 96 0 0 0 0 96 0 0 0 0 96 0 0 0 0 96 0 0 0 0 96 0 0 0 0 96 0 0 0 0 96 0 0 0 0 96 0 0 0 0 96 0 0 0 0 96 0 0 0 0 96 141 0 1 0 90 0 0 1 0 
90 0 0 1 0 96 0 0 0 0 96 0 0 0 0 96 0 0 0 0 96 0 0 0 0 96 0 0 0 0 96 0 0 0 0 96 0 0 0 0 96 0 0 0 0 96 0 0 0 0 96 0 0 0 0 96 0 0 0 0 96 142 0 1 0 90 0 0 1 0 
90 0 0 1 0 96 0 0 0 0 96 0 0 0 0 96 0 0 0 0 96 0 0 0 0 96 0 0 0 0 96 0 0 0 0 96 0 0 0 0 96 0 0 0 0 96 0 0 0 0 96 117 0 1 0 96 0 0 0 0 96 134 0 1 0 90 0 0 1 0 
89 0 0 1 0 88 0 0 1 0 88 0 0 1 0 88 0 0 1 0 88 0 0 1 0 88 0 0 1 0 88 0 0 1 0 88 0 0 1 0 88 0 0 1 0 88 0 0 1 0 88 0 0 1 0 88 0 0 1 0 88 0 0 1 0 89 0 0 1 0 