50 50
87 0 0 0 0 87 0 0 0 0 87 0 0 0 0 87 0 0 0 0 87 0 0 0 0 87 0 0 0 0 87 0 0 0 0 87 0 0 0 0 87 0 0 0 0 87 0 0 0 0 87 0 0 0 0 87 0 0 0 0 87 0 0 0 0 87 0 0 0 0 87 0 0 0 0 87 0 0 0 0 87 0 0 0 0 87 0 0 0 0 87 0 0 0 0 87 0 0 0 0 87 0 0 0 0 87 0 0 0 0 87 0 0 0 0 87 0 0 0 0 87 0 0 0 0 87 0 0 0 0 87 0 0 0 0 87 0 0 0 0 87 0 0 0 0 87 0 0 0 0 87 0 0 0 0 87 0 0 0 0 87 0 0 0 0 87 0 0 0 0 87 0 0 0 0 87 0 0 0 0 87 0 0 0 0 87 0 0 0 0 87 0 0 0 0 87 0 0 0 0 87 0 0 0 0 87 0 0 0 0 87 0 0 0 0 87 0 0 0 0 87 0 0 0 0 87 0 0 0 0 87 0 0 0 0 87 0 0 0 0 87 0 0 0 0 87 0 0 0 0 
87 0 0 0 0 87 0 0 0 0 87 0 0 0 0 87 0 0 0 0 87 0 0 0 0 87 0 0 0 0 87 0 0 0 0 87 0 0 0 0 87 0 0 0 0 87 0 0 0 0 87 0 0 0 0 87 0 0 0 0 87 0 0 0 0 87 0 0 0 0 87 0 0 0 0 87 0 0 0 0 87 0 0 0 0 87 0 0 0 0 87 0 0 0 0 87 0 0 0 0 87 0 0 0 0 87 0 0 0 0 87 0 0 0 0 87 0 0 0 0 87 0 0 0 0 87 0 0 0 0 87 0 0 0 0 87 0 0 0 0 87 0 0 0 0 87 0 0 0 0 87 0 0 0 0 87 0 0 0 0 87 0 0 0 0 87 0 0 0 0 87 0 0 0 0 87 0 0 0 0 87 0 0 0 0 87 0 0 0 0 87 0 0 0 0 87 0 0 0 0 87 0 0 0 0 87 0 0 0 0 87 0 0 0 0 87 0 0 0 0 87 0 0 0 0 87 0 0 0 0 87 0 0 0 0 87 0 0 0 0 87 0 0 0 0 87 0 0 0 0 
87 0 0 1 0 87 0 0 1 0 87 0 0 1 0 87 0 0 1 0 87 0 0 1 0 87 0 0 1 0 87 0 0 1 0 87 0 0 0 0 87 0 0 0 0 87 0 0 0 0 87 0 0 0 0 87 0 0 0 0 87 0 0 0 0 87 0 0 0 0 87 0 0 0 0 87 0 0 0 0 87 0 0 0 0 87 0 0 0 0 87 0 0 0 0 87 0 0 0 0 87 0 0 0 0 87 0 0 0 0 87 0 0 0 0 87 0 0 0 0 87 0 0 0 0 87 0 0 0 0 87 0 0 0 0 87 0 0 0 0 87 0 0 0 0 87 0 0 0 0 87 0 0 0 0 87 0 0 0 0 87 0 0 0 0 87 0 0 0 0 87 0 0 0 0 87 0 0 0 0 87 0 0 0 0 87 0 0 0 0 87 0 0 0 0 87 0 0 0 0 87 0 0 0 0 87 0 0 0 0 87 0 0 0 0 87 0 0 0 0 87 0 0 0 0 87 0 0 0 0 87 0 0 0 0 87 0 0 0 0 87 0 0 0 0 87 0 0 0 0 
96 0 0 0 0 96 0 0 0 0 96 0 0 0 0 96 0 0 0 0 96 0 0 0 0 96 0 0 0 0 87 0 0 1 0 87 0 0 0 0 87 0 0 0 0 87 0 0 0 0 87 0 0 0 0 87 0 0 0 0 87 0 0 0 0 87 0 0 0 0 87 0 0 0 0 87 0 0 0 0 87 0 0 0 0 87 0 0 0 0 87 0 0 0 0 87 0 0 0 0 87 0 0 0 0 87 0 0 0 0 87 0 0 0 0 87 0 0 0 0 87 0 0 0 0 87 0 0 0 0 87 0 0 1 0 87 0 0 1 0 87 0 0 1 0 87 0 0 1 0 87 0 0 1 0 87 0 0 1 0 87 0 0 1 0 87 0 0 1 0 87 0 0 1 0 87 0 0 1 0 87 0 0 1 0 87 0 0 1 0 87 0 0 0 0 87 0 0 0 0 87 0 0 0 0 87 0 0 0 0 87 0 0 0 0 87 0 0 0 0 87 0 0 0 0 87 0 0 0 0 87 0 0 0 0 87 0 0 0 0 87 0 0 0 0 87 0 0 0 0 
96 0 0 0 0 96 0 0 0 0 96 0 0 0 0 96 0 0 0 0 96 0 0 0 0 96 0 0 0 0 87 0 0 1 0 87 0 0 0 0 87 0 0 0 0 87 0 0 0 0 87 0 0 0 0 87 0 0 0 0 87 0 0 0 0 87 0 0 0 0 87 0 0 0 0 87 0 0 0 0 87 0 0 0 0 87 0 0 0 0 87 0 0 0 0 87 0 0 0 0 87 0 0 0 0 87 0 0 0 0 87 0 0 0 0 87 0 0 1 0 87 0 0 1 0 87 0 0 1 0 96 0 0 0 0 96 0 0 0 0 96 0 0 0 0 96 0 0 0 0 96 0 0 0 0 96 0 0 0 0 96 0 0 0 0 96 0 0 0 0 96 0 0 0 0 96 0 0 0 0 96 0 0 0 0 87 0 0 1 0 87 0 0 0 0 87 0 0 0 0 87 0 0 0 0 87 0 0 0 0 87 0 0 0 0 87 0 0 0 0 87 0 0 0 0 87 0 0 0 0 87 0 0 0 0 87 0 0 0 0 87 0 0 0 0 87 0 0 0 0 
96 0 0 0 0 96 0 0 0 0 96 0 0 0 0 96 0 0 0 0 96 0 0 0 0 96 0 0 0 0 87 0 0 1 0 87 0 0 0 0 87 0 0 0 0 87 0 0 0 0 87 0 0 0 0 87 0 0 0 0 87 0 0 0 0 87 0 0 0 0 87 0 0 0 0 87 0 0 0 0 87 0 0 0 0 87 0 0 0 0 87 0 0 0 0 87 0 0 0 0 87 0 0 0 0 87 0 0 0 0 87 0 0 0 0 87 0 0 1 0 96 0 0 0 0 96 0 0 0 0 96 0 0 0 0 96 0 0 0 0 96 0 0 0 0 96 0 0 0 0 96 0 0 0 0 96 0 0 0 0 96 0 0 0 0 96 0 0 0 0 96 0 0 0 0 96 0 0 0 0 96 0 0 0 0 87 0 0 1 0 87 0 0 0 0 87 0 0 0 0 87 0 0 0 0 87 0 0 0 0 87 0 0 0 0 87 0 0 0 0 87 0 0 0 0 87 0 0 0 0 87 0 0 0 0 87 0 0 0 0 87 0 0 0 0 87 0 0 0 0 
98 0 0 1 0 98 0 0 1 0 98 0 0 1 0 96 0 0 0 0 96 0 0 0 0 96 0 0 0 0 87 0 0 1 0 87 0 0 0 0 87 0 0 0 0 87 0 0 0 0 87 0 0 0 0 87 0 0 0 0 87 0 0 0 0 87 0 0 0 0 87 0 0 0 0 87 0 0 0 0 87 0 0 0 0 87 0 0 0 0 87 0 0 0 0 87 0 0 0 0 87 0 0 0 0 87 0 0 0 0 87 0 0 0 0 87 0 0 1 0 96 0 0 0 0 96 0 0 0 0 96 0 0 0 0 91 0 0 1 0 88 0 0 1 0 88 0 0 1 0 88 0 0 1 0 88 0 0 1 0 88 0 0 1 0 96 132 0 1 0 88 0 0 1 0 91 0 0 1 0 96 0 0 0 0 87 0 0 1 0 87 0 0 1 0 87 0 0 1 0 87 0 0 0 0 87 0 0 0 0 87 0 0 0 0 87 0 0 0 0 87 0 0 0 0 87 0 0 0 0 87 0 0 0 0 87 0 0 0 0 87 0 0 0 0 87 0 0 0 0 
87 0 0 0 0 87 0 0 0 0 87 0 0 1 0 96 0 0 0 0 96 0 0 0 0 96 0 0 0 0 87 0 0 1 0 87 0 0 0 0 87 0 0 0 0 87 0 0 0 0 87 0 0 0 0 87 0 0 0 0 87 0 0 0 0 87 0 0 0 0 87 0 0 0 0 87 0 0 0 0 87 0 0 0 0 87 0 0 0 0 87 0 0 0 0 87 0 0 0 0 87 0 0 0 0 87 0 0 0 0 87 0 0 1 0 87 0 0 1 0 96 0 0 0 0 96 0 0 0 0 96 0 0 0 0 90 0 0 1 0 96 0 0 0 0 96 0 0 0 0 96 0 0 0 0 96 0 0 0 0 96 0 0 0 0 96 0 0 0 0 96 0 0 0 0 90 0 0 1 0 96 0 0 0 0 96 0 0 0 0 96 0 0 0 0 87 0 0 1 0 87 0 0 1 0 87 0 0 0 0 87 0 0 0 0 87 0 0 0 0 87 0 0 0 0 87 0 0 0 0 87 0 0 0 0 87 0 0 0 0 87 0 0 0 0 87 0 0 0 0 
87 0 0 0 0 87 0 0 0 0 87 0 0 1 0 96 0 0 0 0 96 0 0 0 0 96 0 0 0 0 87 0 0 1 0 87 0 0 0 0 87 0 0 0 0 87 0 0 0 0 87 0 0 0 0 87 0 0 0 0 87 0 0 0 0 87 0 0 0 0 87 0 0 0 0 87 0 0 0 0 87 0 0 0 0 87 0 0 0 0 87 0 0 0 0 87 0 0 0 0 87 0 0 0 0 87 0 0 0 0 87 0 0 1 0 96 0 0 0 0 96 0 0 0 0 96 0 0 0 0 96 0 0 0 0 90 0 0 1 0 96 0 0 0 0 96 0 0 0 0 96 0 0 0 0 96 0 0 0 0 96 0 0 0 0 96 0 0 0 0 96 0 0 0 0 90 0 0 1 0 96 0 0 0 0 96 0 0 0 0 96 0 0 0 0 96 0 0 0 0 87 0 0 1 0 87 0 0 0 0 87 0 0 0 0 87 0 0 0 0 87 0 0 0 0 87 0 0 0 0 87 0 0 0 0 87 0 0 0 0 87 0 0 0 0 87 0 0 0 0 
87 0 0 0 0 87 0 0 0 0 87 0 0 1 0 96 0 0 0 0 96 0 0 0 0 96 0 0 0 0 87 0 0 1 0 87 0 0 0 0 87 0 0 0 0 87 0 0 0 0 87 0 0 0 0 87 0 0 0 0 87 0 0 0 0 87 0 0 0 0 87 0 0 0 0 87 0 0 0 0 87 0 0 0 0 87 0 0 0 0 87 0 0 0 0 87 0 0 0 0 87 0 0 0 0 87 0 0 0 0 87 0 0 1 0 96 0 0 0 0 96 0 0 0 0 96 0 0 0 0 96 0 0 0 0 90 0 0 1 0 96 0 0 0 0 96 0 0 0 0 96 0 0 0 0 96 0 0 0 0 96 0 0 0 0 96 0 0 0 0 96 0 0 0 0 90 0 0 1 0 96 0 0 0 0 96 0 0 0 0 96 0 0 0 0 96 0 0 0 0 87 0 0 1 0 87 0 0 0 0 87 0 0 0 0 87 0 0 0 0 87 0 0 0 0 87 0 0 0 0 87 0 0 0 0 87 0 0 0 0 87 0 0 0 0 87 0 0 0 0 
87 0 0 0 0 87 0 0 0 0 87 0 0 1 0 96 0 0 0 0 96 0 0 0 0 96 0 0 0 0 87 0 0 1 0 87 0 0 0 0 87 0 0 0 0 87 0 0 0 0 87 0 0 0 0 87 0 0 0 0 87 0 0 0 0 87 0 0 0 0 87 0 0 0 0 87 0 0 0 0 87 0 0 0 0 87 0 0 0 0 87 0 0 0 0 87 0 0 0 0 87 0 0 0 0 87 0 0 0 0 87 0 0 1 0 96 0 0 0 0 96 0 0 0 0 96 117 0 0 0 96 0 0 0 0 90 0 0 1 0 96 0 0 0 0 96 0 0 0 0 96 0 0 0 0 96 0 0 0 0 96 0 0 0 0 96 0 0 0 0 96 0 0 0 0 90 0 0 1 0 96 0 0 0 0 96 0 0 0 0 96 0 0 0 0 96 0 0 0 0 87 0 0 1 0 87 0 0 0 0 87 0 0 0 0 87 0 0 0 0 87 0 0 0 0 87 0 0 0 0 87 0 0 0 0 87 0 0 0 0 87 0 0 0 0 87 0 0 0 0 
87 0 0 0 0 87 0 0 0 0 87 0 0 1 0 96 0 0 0 0 96 0 0 0 0 96 0 0 0 0 87 0 0 1 0 87 0 0 1 0 87 0 0 1 0 87 0 0 1 0 87 0 0 1 0 87 0 0 1 0 87 0 0 1 0 87 0 0 1 0 87 0 0 1 0 87 0 0 1 0 87 0 0 1 0 87 0 0 1 0 87 0 0 1 0 87 0 0 1 0 87 0 0 1 0 87 0 0 1 0 87 0 0 1 0 88 0 0 1 0 88 0 0 1 0 88 0 0 1 0 88 0 0 1 0 89 0 0 1 0 96 0 0 0 0 96 0 0 0 0 96 0 0 0 0 96 0 0 0 0 96 0 0 0 0 96 0 0 0 0 96 0 0 0 0 89 0 0 1 0 88 0 0 1 0 91 0 0 1 0 96 0 0 0 0 96 0 0 0 0 87 0 0 1 0 87 0 0 1 0 87 0 0 0 0 87 0 0 0 0 87 0 0 0 0 87 0 0 0 0 87 0 0 0 0 87 0 0 0 0 87 0 0 0 0 87 0 0 0 0 
87 0 0 0 0 87 0 0 0 0 87 0 0 1 0 96 0 0 0 0 96 0 0 0 0 96 0 0 0 0 87 0 0 1 0 96 0 0 0 0 96 0 0 0 0 96 0 0 0 0 96 0 0 0 0 96 114 0 1 0 96 0 0 0 0 96 0 0 0 0 96 0 0 0 0 96 0 0 0 0 96 114 0 1 0 96 0 0 0 0 96 0 0 0 0 96 0 0 0 0 96 0 0 0 0 96 114 0 1 0 96 0 0 0 0 96 0 0 0 0 96 0 0 0 0 96 0 0 0 0 96 0 0 0 0 96 0 0 0 0 96 0 0 0 0 96 0 0 0 0 96 0 0 0 0 96 0 0 0 0 96 0 0 0 0 96 0 0 0 0 96 0 0 0 0 96 0 0 0 0 96 0 0 0 0 90 0 0 1 0 96 0 0 0 0 96 0 0 0 0 96 0 0 0 0 87 0 0 1 0 87 0 0 0 0 87 0 0 0 0 87 0 0 0 0 87 0 0 0 0 87 0 0 0 0 87 0 0 0 0 87 0 0 0 0 87 0 0 0 0 
87 0 0 0 0 87 0 0 0 0 87 0 0 1 0 96 0 0 0 0 96 0 0 0 0 96 0 0 0 0 87 0 0 1 0 96 0 0 0 0 96 0 0 0 0 96 0 0 0 0 96 0 0 0 0 96 0 0 0 0 96 0 0 0 0 96 0 0 0 0 96 0 0 0 0 96 0 0 0 0 96 0 0 0 0 96 0 0 0 0 96 0 0 0 0 96 0 0 0 0 96 0 0 0 0 96 0 0 0 0 96 0 0 0 0 96 0 0 0 0 96 0 0 0 0 96 0 0 0 0 96 0 0 0 0 96 0 0 0 0 96 0 0 0 0 96 0 0 0 0 96 0 0 0 0 96 0 0 0 0 96 0 0 0 0 96 0 0 0 0 96 0 0 0 0 96 0 0 0 0 96 0 0 0 0 90 0 0 1 0 96 0 0 0 0 96 117 0 0 0 96 0 0 0 0 87 0 0 1 0 87 0 0 1 0 87 0 0 0 0 87 0 0 0 0 87 0 0 0 0 87 0 0 0 0 87 0 0 0 0 87 0 0 0 0 87 0 0 0 0 
87 0 0 0 0 87 0 0 0 0 87 0 0 1 0 96 0 0 0 0 96 0 0 0 0 96 0 0 0 0 87 0 0 1 0 96 0 0 0 0 96 0 0 0 0 96 0 0 0 0 96 0 0 0 0 96 0 0 0 0 96 0 0 0 0 96 0 0 0 0 96 0 0 0 0 96 0 0 0 0 96 0 0 0 0 96 0 0 0 0 96 0 0 0 0 96 0 0 0 0 96 0 0 0 0 96 0 0 0 0 96 0 0 0 0 96 0 0 0 0 96 0 0 0 0 96 0 0 0 0 96 0 0 0 0 96 0 0 0 0 96 0 0 0 0 96 0 0 0 0 96 0 0 0 0 96 0 0 0 0 96 0 0 0 0 96 0 0 0 0 96 0 0 0 0 96 0 0 0 0 96 0 0 0 0 90 0 0 1 0 96 0 0 0 0 96 0 0 0 0 96 0 0 0 0 96 0 0 0 0 87 0 0 1 0 87 0 0 0 0 87 0 0 0 0 87 0 0 0 0 87 0 0 0 0 87 0 0 0 0 87 0 0 0 0 87 0 0 0 0 
87 0 0 0 0 87 0 0 0 0 87 0 0 1 0 96 0 0 0 0 96 0 0 0 0 96 0 0 0 0 87 0 0 1 0 96 0 0 0 0 96 0 0 0 0 96 0 0 0 0 98 0 0 1 0 98 0 0 1 0 98 0 0 1 0 98 0 0 1 0 98 0 0 1 0 98 0 0 1 0 98 0 0 1 0 98 0 0 1 0 98 0 0 1 0 98 0 0 1 0 98 0 0 1 0 98 0 0 1 0 98 0 0 1 0 88 0 0 1 0 88 0 0 1 0 88 0 0 1 0 88 0 0 1 0 88 0 0 1 0 91 0 0 1 0 96 0 0 0 0 96 0 0 0 0 96 0 0 0 0 96 0 0 0 0 96 0 0 0 0 96 0 0 0 0 96 0 0 0 0 96 0 0 0 0 90 0 0 1 0 96 0 0 0 0 96 0 0 0 0 96 0 0 0 0 96 0 0 0 0 87 0 0 1 0 87 0 0 0 0 87 0 0 0 0 87 0 0 0 0 87 0 0 0 0 87 0 0 0 0 87 0 0 0 0 87 0 0 0 0 
87 0 0 0 0 87 0 0 0 0 87 0 0 1 0 96 0 0 0 0 96 0 0 0 0 96 0 0 0 0 87 0 0 1 0 96 0 0 0 0 96 0 0 0 0 96 0 0 0 0 87 0 0 1 0 87 0 0 0 0 87 0 0 0 0 87 0 0 0 0 87 0 0 0 0 87 0 0 0 0 87 0 0 0 0 87 0 0 0 0 87 0 0 0 0 87 0 0 0 0 87 0 0 0 0 87 0 0 0 0 87 0 0 1 0 96 0 0 0 0 96 0 0 0 0 96 0 0 0 0 96 0 0 0 0 96 0 0 0 0 90 0 0 1 0 96 0 0 0 0 96 0 0 0 0 96 0 0 0 0 96 0 0 0 0 96 0 0 0 0 96 0 0 0 0 96 0 0 0 0 96 0 0 0 0 90 0 0 1 0 96 0 0 0 0 96 0 0 0 0 96 0 0 0 0 96 0 0 0 0 87 0 0 1 0 87 0 0 0 0 87 0 0 0 0 87 0 0 0 0 87 0 0 0 0 87 0 0 0 0 87 0 0 0 0 87 0 0 0 0 
91 0 0 1 0 88 0 0 1 0 88 0 0 1 0 96 0 0 0 0 96 0 0 0 0 96 0 0 0 0 88 0 0 1 0 88 0 0 1 0 96 0 0 0 0 88 0 0 1 0 88 0 0 1 0 91 0 0 1 0 87 0 0 0 0 87 0 0 0 0 87 0 0 0 0 87 0 0 0 0 87 0 0 0 0 87 0 0 0 0 87 0 0 0 0 87 0 0 0 0 87 0 0 0 0 87 0 0 0 0 87 0 0 1 0 96 0 0 0 0 96 0 0 0 0 96 0 0 0 0 96 0 0 0 0 96 0 0 0 0 89 0 0 1 0 88 0 0 1 0 91 0 0 1 0 96 0 0 0 0 96 0 0 0 0 96 0 0 0 0 96 0 0 0 0 91 0 0 1 0 88 0 0 1 0 89 0 0 1 0 96 0 0 0 0 96 0 0 0 0 96 0 0 0 0 96 0 0 0 0 87 0 0 1 0 87 0 0 0 0 87 0 0 0 0 87 0 0 0 0 87 0 0 0 0 87 0 0 0 0 87 0 0 0 0 87 0 0 0 0 
90 0 0 1 0 96 0 0 0 0 96 0 0 0 0 96 0 0 0 0 96 0 0 0 0 96 0 0 0 0 96 0 0 0 0 96 0 0 0 0 96 0 0 0 0 96 0 0 0 0 96 0 0 0 0 90 0 0 1 0 87 0 0 0 0 87 0 0 0 0 87 0 0 0 0 87 0 0 0 0 87 0 0 0 0 87 0 0 0 0 87 0 0 0 0 87 0 0 0 0 87 0 0 0 0 87 0 0 0 0 87 0 0 1 0 98 0 0 1 0 98 0 0 1 0 96 0 0 0 0 96 0 0 0 0 96 0 0 0 0 96 0 0 0 0 96 0 0 0 0 90 0 0 1 0 96 0 0 0 0 96 0 0 0 0 96 0 0 0 0 96 0 0 0 0 90 0 0 1 0 96 0 0 0 0 96 0 0 0 0 96 0 0 0 0 96 0 0 0 0 96 0 0 0 0 96 0 0 0 0 87 0 0 1 0 87 0 0 0 0 87 0 0 0 0 87 0 0 0 0 87 0 0 0 0 87 0 0 0 0 87 0 0 0 0 87 0 0 0 0 
90 0 0 1 0 96 117 0 0 0 96 0 0 0 0 96 0 104 0 0 96 0 0 0 0 96 0 0 0 0 96 0 0 0 0 96 0 0 0 0 96 0 104 0 0 96 0 0 0 0 96 0 0 0 0 90 0 0 1 0 87 0 0 0 0 87 0 0 0 0 87 0 0 0 0 87 0 0 0 0 87 0 0 0 0 87 0 0 0 0 87 0 0 0 0 87 0 0 0 0 87 0 0 0 0 87 0 0 0 0 87 0 0 0 0 87 0 0 0 0 87 0 0 1 0 96 0 0 0 0 96 0 0 0 0 96 0 0 0 0 96 0 0 0 0 96 0 0 0 0 90 0 0 1 0 96 0 0 0 0 96 0 0 0 0 96 0 0 0 0 96 0 0 0 0 90 0 0 1 0 96 0 0 0 0 96 0 0 0 0 96 0 0 0 0 96 0 0 0 0 96 0 0 0 0 96 0 0 0 0 87 0 0 1 0 87 0 0 0 0 87 0 0 0 0 87 0 0 0 0 87 0 0 0 0 87 0 0 0 0 87 0 0 0 0 87 0 0 0 0 
90 0 0 1 0 96 0 0 0 0 96 0 0 0 0 96 0 105 0 0 96 0 0 0 0 96 0 0 0 0 96 0 0 0 0 96 0 0 0 0 96 0 105 0 0 96 0 0 0 0 96 0 0 0 0 90 0 0 1 0 87 0 0 0 0 87 0 0 0 0 87 0 0 0 0 87 0 0 0 0 87 0 0 0 0 87 0 0 0 0 87 0 0 0 0 87 0 0 0 0 87 0 0 0 0 87 0 0 0 0 87 0 0 0 0 87 0 0 0 0 87 0 0 1 0 98 0 0 1 0 96 0 0 0 0 96 0 0 0 0 96 0 0 0 0 96 0 0 0 0 90 0 0 1 0 96 0 0 0 0 96 0 0 0 0 96 0 0 0 0 96 0 0 0 0 90 0 0 1 0 96 0 0 0 0 96 0 0 0 0 96 0 0 0 0 96 117 0 0 0 96 0 0 0 0 96 0 0 0 0 87 0 0 1 0 87 0 0 0 0 87 0 0 0 0 87 0 0 0 0 87 0 0 0 0 87 0 0 0 0 87 0 0 0 0 87 0 0 0 0 
90 0 0 1 0 96 0 0 0 0 96 0 0 0 0 96 103 0 1 0 96 0 0 0 0 96 0 0 0 0 96 0 0 0 0 96 0 0 0 0 96 103 0 1 0 96 0 0 0 0 96 0 0 0 0 90 0 0 1 0 87 0 0 0 0 87 0 0 0 0 87 0 0 0 0 87 0 0 0 0 87 0 0 0 0 87 0 0 0 0 87 0 0 0 0 87 0 0 0 0 87 0 0 0 0 87 0 0 0 0 87 0 0 0 0 87 0 0 0 0 87 0 0 0 0 87 0 0 1 0 98 0 0 1 0 98 0 0 1 0 96 0 0 0 0 96 0 0 0 0 90 0 0 1 0 96 0 0 0 0 96 0 0 0 0 96 0 0 0 0 96 0 0 0 0 90 0 0 1 0 96 0 0 0 0 96 0 0 0 0 96 0 0 0 0 96 0 0 0 0 96 0 0 0 0 98 0 0 1 0 87 0 0 1 0 87 0 0 0 0 87 0 0 0 0 87 0 0 0 0 87 0 0 0 0 87 0 0 0 0 87 0 0 0 0 87 0 0 0 0 
90 0 0 1 0 96 0 0 0 0 96 0 0 0 0 96 0 0 0 0 96 0 0 0 0 96 0 0 0 0 96 0 0 0 0 96 0 0 0 0 96 117 0 0 0 96 0 0 0 0 96 0 0 0 0 90 0 0 1 0 87 0 0 0 0 87 0 0 0 0 87 0 0 0 0 87 0 0 0 0 87 0 0 0 0 87 0 0 0 0 87 0 0 0 0 87 0 0 0 0 87 0 0 0 0 87 0 0 0 0 87 0 0 0 0 87 0 0 0 0 87 0 0 0 0 87 0 0 0 0 87 0 0 0 0 87 0 0 1 0 96 0 0 0 0 96 0 0 0 0 90 0 0 1 0 96 0 0 0 0 96 0 0 0 0 96 0 0 0 0 96 0 0 0 0 90 0 0 1 0 96 0 0 0 0 96 0 0 0 0 96 0 0 0 0 96 0 0 0 0 96 0 0 0 0 87 0 0 1 0 87 0 0 0 0 87 0 0 0 0 87 0 0 0 0 87 0 0 0 0 87 0 0 0 0 87 0 0 0 0 87 0 0 0 0 87 0 0 0 0 
89 0 0 1 0 88 0 0 1 0 88 0 0 1 0 88 0 0 1 0 88 0 0 1 0 88 0 0 1 0 88 0 0 1 0 88 0 0 1 0 88 0 0 1 0 88 0 0 1 0 88 0 0 1 0 89 0 0 1 0 87 0 0 0 0 87 0 0 0 0 87 0 0 0 0 87 0 0 0 0 87 0 0 0 0 87 0 0 0 0 87 0 0 0 0 87 0 0 0 0 87 0 0 0 0 87 0 0 0 0 87 0 0 0 0 87 0 0 0 0 87 0 0 0 0 87 0 0 0 0 87 0 0 0 0 87 0 0 1 0 96 0 0 0 0 96 0 0 0 0 90 0 0 1 0 96 0 0 0 0 96 0 0 0 0 96 0 0 0 0 96 0 0 0 0 90 0 0 1 0 96 0 0 0 0 96 0 0 0 0 96 0 0 0 0 96 0 0 0 0 96 0 0 0 0 87 0 0 1 0 87 0 0 0 0 87 0 0 0 0 87 0 0 0 0 87 0 0 0 0 87 0 0 0 0 87 0 0 0 0 87 0 0 0 0 87 0 0 0 0 
98 0 0 0 0 98 0 0 0 0 98 0 0 0 0 98 0 0 0 0 98 0 0 0 0 98 0 0 0 0 98 0 0 0 0 98 0 0 0 0 98 0 0 0 0 98 0 0 0 0 98 0 0 0 0 98 0 0 0 0 87 0 0 0 0 87 0 0 0 0 87 0 0 0 0 87 0 0 0 0 87 0 0 0 0 87 0 0 0 0 87 0 0 0 0 87 0 0 0 0 87 0 0 0 0 87 0 0 0 0 87 0 0 0 0 87 0 0 0 0 87 0 0 0 0 87 0 0 0 0 87 0 0 0 0 87 0 0 1 0 96 0 0 0 0 96 0 0 0 0 96 0 0 0 0 96 0 0 0 0 96 0 0 0 0 96 0 0 0 0 96 0 0 0 0 96 0 0 0 0 96 0 0 0 0 96 0 0 0 0 96 0 0 0 0 96 0 0 0 0 96 0 0 0 0 87 0 0 1 0 87 0 0 0 0 87 0 0 0 0 87 0 0 0 0 87 0 0 0 0 87 0 0 0 0 87 0 0 0 0 87 0 0 0 0 87 0 0 0 0 
87 0 0 0 0 87 0 0 0 0 87 0 0 0 0 87 0 0 0 0 87 0 0 0 0 87 0 0 0 0 87 0 0 0 0 87 0 0 0 0 87 0 0 0 0 87 0 0 0 0 87 0 0 0 0 87 0 0 0 0 87 0 0 0 0 87 0 0 0 0 87 0 0 0 0 87 0 0 0 0 87 0 0 0 0 87 0 0 0 0 87 0 0 0 0 87 0 0 0 0 87 0 0 0 0 87 0 0 0 0 87 0 0 0 0 87 0 0 0 0 87 0 0 0 0 87 0 0 0 0 87 0 0 0 0 87 0 0 1 0 96 0 0 0 0 96 0 0 0 0 96 117 0 0 0 96 0 0 0 0 96 0 0 0 0 96 0 0 0 0 96 0 0 0 0 96 0 0 0 0 96 0 0 0 0 96 0 0 0 0 98 0 0 1 0 98 0 0 1 0 98 0 0 1 0 87 0 0 1 0 87 0 0 0 0 87 0 0 0 0 87 0 0 0 0 87 0 0 0 0 87 0 0 0 0 87 0 0 0 0 87 0 0 0 0 87 0 0 0 0 
87 0 0 0 0 87 0 0 0 0 87 0 0 0 0 87 0 0 0 0 87 0 0 0 0 87 0 0 0 0 87 0 0 0 0 87 0 0 0 0 87 0 0 0 0 87 0 0 0 0 87 0 0 0 0 87 0 0 0 0 87 0 0 0 0 87 0 0 0 0 87 0 0 0 0 87 0 0 0 0 87 0 0 0 0 87 0 0 0 0 87 0 0 0 0 87 0 0 0 0 87 0 0 0 0 87 0 0 0 0 87 0 0 0 0 87 0 0 0 0 87 0 0 0 0 87 0 0 0 0 87 0 0 0 0 87 0 0 1 0 96 0 0 0 0 96 0 0 0 0 96 0 0 0 0 96 117 0 0 0 96 0 0 0 0 96 0 0 0 0 98 0 0 1 0 98 0 0 1 0 98 0 0 1 0 98 0 0 1 0 87 0 0 1 0 87 0 0 0 0 87 0 0 0 0 87 0 0 0 0 87 0 0 0 0 87 0 0 0 0 87 0 0 0 0 87 0 0 0 0 87 0 0 0 0 87 0 0 0 0 87 0 0 0 0 87 0 0 0 0 
87 0 0 0 0 87 0 0 0 0 87 0 0 0 0 87 0 0 0 0 87 0 0 0 0 87 0 0 0 0 87 0 0 0 0 87 0 0 0 0 87 0 0 0 0 87 0 0 0 0 87 0 0 0 0 87 0 0 0 0 87 0 0 0 0 87 0 0 0 0 87 0 0 0 0 87 0 0 0 0 87 0 0 0 0 87 0 0 0 0 87 0 0 0 0 87 0 0 0 0 87 0 0 0 0 87 0 0 0 0 87 0 0 0 0 87 0 0 0 0 87 0 0 0 0 87 0 0 0 0 87 0 0 0 0 87 0 0 1 0 98 0 0 1 0 98 0 0 1 0 98 0 0 1 0 98 0 0 1 0 98 0 0 1 0 98 0 0 1 0 87 0 0 1 0 87 0 0 0 0 87 0 0 0 0 87 0 0 0 0 87 0 0 0 0 87 0 0 0 0 87 0 0 0 0 87 0 0 0 0 87 0 0 0 0 87 0 0 0 0 87 0 0 0 0 87 0 0 0 0 87 0 0 0 0 87 0 0 0 0 87 0 0 0 0 87 0 0 0 0 
87 0 0 0 0 87 0 0 0 0 87 0 0 0 0 87 0 0 0 0 87 0 0 0 0 87 0 0 0 0 87 0 0 0 0 87 0 0 0 0 87 0 0 0 0 87 0 0 0 0 87 0 0 0 0 87 0 0 0 0 87 0 0 0 0 87 0 0 0 0 87 0 0 0 0 87 0 0 0 0 87 0 0 0 0 87 0 0 0 0 87 0 0 0 0 87 0 0 0 0 87 0 0 0 0 87 0 0 0 0 87 0 0 0 0 87 0 0 0 0 87 0 0 0 0 87 0 0 0 0 87 0 0 0 0 87 0 0 0 0 87 0 0 0 0 87 0 0 0 0 87 0 0 0 0 87 0 0 0 0 87 0 0 0 0 87 0 0 0 0 87 0 0 0 0 87 0 0 0 0 87 0 0 0 0 87 0 0 0 0 87 0 0 0 0 87 0 0 0 0 87 0 0 0 0 87 0 0 0 0 87 0 0 0 0 87 0 0 0 0 87 0 0 0 0 87 0 0 0 0 87 0 0 0 0 87 0 0 0 0 87 0 0 0 0 87 0 0 0 0 
87 0 0 0 0 87 0 0 0 0 87 0 0 0 0 87 0 0 0 0 87 0 0 0 0 87 0 0 0 0 87 0 0 0 0 87 0 0 0 0 87 0 0 0 0 87 0 0 0 0 87 0 0 0 0 87 0 0 0 0 87 0 0 0 0 87 0 0 0 0 87 0 0 0 0 87 0 0 0 0 87 0 0 0 0 87 0 0 0 0 87 0 0 0 0 87 0 0 0 0 87 0 0 0 0 87 0 0 0 0 87 0 0 0 0 87 0 0 0 0 87 0 0 0 0 87 0 0 0 0 87 0 0 0 0 87 0 0 0 0 87 0 0 0 0 87 0 0 0 0 87 0 0 0 0 87 0 0 0 0 87 0 0 0 0 87 0 0 0 0 87 0 0 0 0 87 0 0 0 0 87 0 0 0 0 87 0 0 0 0 87 0 0 0 0 87 0 0 0 0 87 0 0 0 0 87 0 0 0 0 87 0 0 0 0 87 0 0 0 0 87 0 0 0 0 87 0 0 0 0 87 0 0 0 0 87 0 0 0 0 87 0 0 0 0 87 0 0 0 0 
87 0 0 0 0 87 0 0 0 0 87 0 0 0 0 87 0 0 0 0 87 0 0 0 0 87 0 0 0 0 87 0 0 0 0 87 0 0 0 0 87 0 0 0 0 87 0 0 0 0 87 0 0 0 0 87 0 0 0 0 87 0 0 0 0 87 0 0 0 0 87 0 0 0 0 87 0 0 0 0 87 0 0 0 0 87 0 0 0 0 87 0 0 0 0 87 0 0 0 0 87 0 0 0 0 87 0 0 0 0 87 0 0 0 0 87 0 0 0 0 87 0 0 0 0 87 0 0 0 0 87 0 0 0 0 87 0 0 0 0 87 0 0 0 0 87 0 0 0 0 87 0 0 0 0 87 0 0 0 0 87 0 0 0 0 87 0 0 0 0 87 0 0 0 0 87 0 0 0 0 87 0 0 0 0 87 0 0 0 0 87 0 0 0 0 87 0 0 0 0 87 0 0 0 0 87 0 0 0 0 87 0 0 0 0 87 0 0 0 0 87 0 0 0 0 87 0 0 0 0 87 0 0 0 0 87 0 0 0 0 87 0 0 0 0 87 0 0 0 0 
87 0 0 0 0 87 0 0 0 0 87 0 0 0 0 87 0 0 0 0 87 0 0 0 0 87 0 0 0 0 87 0 0 0 0 87 0 0 0 0 87 0 0 0 0 87 0 0 0 0 87 0 0 0 0 87 0 0 0 0 87 0 0 0 0 87 0 0 0 0 87 0 0 0 0 87 0 0 0 0 87 0 0 0 0 87 0 0 0 0 87 0 0 0 0 87 0 0 0 0 87 0 0 0 0 87 0 0 0 0 87 0 0 0 0 87 0 0 0 0 87 0 0 0 0 87 0 0 0 0 87 0 0 0 0 87 0 0 0 0 87 0 0 0 0 87 0 0 0 0 87 0 0 0 0 87 0 0 0 0 87 0 0 0 0 87 0 0 0 0 87 0 0 0 0 87 0 0 0 0 87 0 0 0 0 87 0 0 0 0 87 0 0 0 0 87 0 0 0 0 87 0 0 0 0 87 0 0 0 0 87 0 0 0 0 87 0 0 0 0 87 0 0 0 0 87 0 0 0 0 87 0 0 0 0 87 0 0 0 0 87 0 0 0 0 87 0 0 0 0 
87 0 0 0 0 87 0 0 0 0 87 0 0 0 0 87 0 0 0 0 87 0 0 0 0 87 0 0 0 0 87 0 0 0 0 87 0 0 0 0 87 0 0 0 0 87 0 0 0 0 87 0 0 0 0 87 0 0 0 0 87 0 0 0 0 87 0 0 0 0 87 0 0 0 0 87 0 0 0 0 87 0 0 0 0 87 0 0 0 0 87 0 0 0 0 87 0 0 0 0 87 0 0 0 0 87 0 0 0 0 87 0 0 0 0 87 0 0 0 0 87 0 0 0 0 87 0 0 0 0 87 0 0 0 0 87 0 0 0 0 87 0 0 0 0 87 0 0 0 0 87 0 0 0 0 87 0 0 0 0 87 0 0 0 0 87 0 0 0 0 87 0 0 0 0 87 0 0 0 0 87 0 0 0 0 87 0 0 0 0 87 0 0 0 0 87 0 0 0 0 87 0 0 0 0 87 0 0 0 0 87 0 0 0 0 87 0 0 0 0 87 0 0 0 0 87 0 0 0 0 87 0 0 0 0 87 0 0 0 0 87 0 0 0 0 87 0 0 0 0 
87 0 0 0 0 87 0 0 0 0 87 0 0 0 0 87 0 0 0 0 87 0 0 0 0 87 0 0 0 0 87 0 0 0 0 87 0 0 0 0 87 0 0 0 0 87 0 0 0 0 87 0 0 0 0 87 0 0 0 0 87 0 0 0 0 87 0 0 0 0 87 0 0 0 0 87 0 0 0 0 87 0 0 0 0 87 0 0 0 0 87 0 0 0 0 87 0 0 0 0 87 0 0 0 0 87 0 0 0 0 87 0 0 0 0 87 0 0 0 0 87 0 0 0 0 87 0 0 0 0 87 0 0 0 0 87 0 0 0 0 87 0 0 0 0 87 0 0 0 0 87 0 0 0 0 87 0 0 0 0 87 0 0 0 0 87 0 0 0 0 87 0 0 0 0 87 0 0 0 0 87 0 0 0 0 87 0 0 0 0 87 0 0 0 0 87 0 0 0 0 87 0 0 0 0 87 0 0 0 0 87 0 0 0 0 87 0 0 0 0 87 0 0 0 0 87 0 0 0 0 87 0 0 0 0 87 0 0 0 0 87 0 0 0 0 87 0 0 0 0 
87 0 0 0 0 87 0 0 0 0 87 0 0 0 0 87 0 0 0 0 87 0 0 0 0 87 0 0 0 0 87 0 0 0 0 87 0 0 0 0 87 0 0 0 0 87 0 0 0 0 87 0 0 0 0 87 0 0 0 0 87 0 0 0 0 87 0 0 0 0 87 0 0 0 0 87 0 0 0 0 87 0 0 0 0 87 0 0 0 0 87 0 0 0 0 87 0 0 0 0 87 0 0 0 0 87 0 0 0 0 87 0 0 0 0 87 0 0 0 0 87 0 0 0 0 87 0 0 0 0 87 0 0 0 0 87 0 0 0 0 87 0 0 0 0 87 0 0 0 0 87 0 0 0 0 87 0 0 0 0 87 0 0 0 0 87 0 0 0 0 87 0 0 0 0 87 0 0 0 0 87 0 0 0 0 87 0 0 0 0 87 0 0 0 0 87 0 0 0 0 87 0 0 0 0 87 0 0 0 0 87 0 0 0 0 87 0 0 0 0 87 0 0 0 0 87 0 0 0 0 87 0 0 0 0 87 0 0 0 0 87 0 0 0 0 87 0 0 0 0 
87 0 0 0 0 87 0 0 0 0 87 0 0 0 0 87 0 0 0 0 87 0 0 0 0 87 0 0 0 0 87 0 0 0 0 87 0 0 0 0 87 0 0 0 0 87 0 0 0 0 87 0 0 0 0 87 0 0 0 0 87 0 0 0 0 87 0 0 0 0 87 0 0 0 0 87 0 0 0 0 87 0 0 0 0 87 0 0 0 0 87 0 0 0 0 87 0 0 0 0 87 0 0 0 0 87 0 0 0 0 87 0 0 0 0 87 0 0 0 0 87 0 0 0 0 87 0 0 0 0 87 0 0 0 0 87 0 0 0 0 87 0 0 0 0 87 0 0 0 0 87 0 0 0 0 87 0 0 0 0 87 0 0 0 0 87 0 0 0 0 87 0 0 0 0 87 0 0 0 0 87 0 0 0 0 87 0 0 0 0 87 0 0 0 0 87 0 0 0 0 87 0 0 0 0 87 0 0 0 0 87 0 0 0 0 87 0 0 0 0 87 0 0 0 0 87 0 0 0 0 87 0 0 0 0 87 0 0 0 0 87 0 0 0 0 87 0 0 0 0 
87 0 0 0 0 87 0 0 0 0 87 0 0 0 0 87 0 0 0 0 87 0 0 0 0 87 0 0 0 0 87 0 0 0 0 87 0 0 0 0 87 0 0 0 0 87 0 0 0 0 87 0 0 0 0 87 0 0 0 0 87 0 0 0 0 87 0 0 0 0 87 0 0 0 0 87 0 0 0 0 87 0 0 0 0 87 0 0 0 0 87 0 0 0 0 87 0 0 0 0 87 0 0 0 0 87 0 0 0 0 87 0 0 0 0 87 0 0 0 0 87 0 0 0 0 87 0 0 0 0 87 0 0 0 0 87 0 0 0 0 87 0 0 0 0 87 0 0 0 0 87 0 0 0 0 87 0 0 0 0 87 0 0 0 0 87 0 0 0 0 87 0 0 0 0 87 0 0 0 0 87 0 0 0 0 87 0 0 0 0 87 0 0 0 0 87 0 0 0 0 87 0 0 0 0 87 0 0 0 0 87 0 0 0 0 87 0 0 0 0 87 0 0 0 0 87 0 0 0 0 87 0 0 0 0 87 0 0 0 0 87 0 0 0 0 87 0 0 0 0 
87 0 0 0 0 87 0 0 0 0 87 0 0 0 0 87 0 0 0 0 87 0 0 0 0 87 0 0 0 0 87 0 0 0 0 87 0 0 0 0 87 0 0 0 0 87 0 0 0 0 87 0 0 0 0 87 0 0 0 0 87 0 0 0 0 87 0 0 0 0 87 0 0 0 0 87 0 0 0 0 87 0 0 0 0 87 0 0 0 0 87 0 0 0 0 87 0 0 0 0 87 0 0 0 0 87 0 0 0 0 87 0 0 0 0 87 0 0 0 0 87 0 0 0 0 87 0 0 0 0 87 0 0 0 0 87 0 0 0 0 87 0 0 0 0 87 0 0 0 0 87 0 0 0 0 87 0 0 0 0 87 0 0 0 0 87 0 0 0 0 87 0 0 0 0 87 0 0 0 0 87 0 0 0 0 87 0 0 0 0 87 0 0 0 0 87 0 0 0 0 87 0 0 0 0 87 0 0 0 0 87 0 0 0 0 87 0 0 0 0 87 0 0 0 0 87 0 0 0 0 87 0 0 0 0 87 0 0 0 0 87 0 0 0 0 87 0 0 0 0 
87 0 0 0 0 87 0 0 0 0 87 0 0 0 0 87 0 0 0 0 87 0 0 0 0 87 0 0 0 0 87 0 0 0 0 87 0 0 0 0 87 0 0 0 0 87 0 0 0 0 87 0 0 0 0 87 0 0 0 0 87 0 0 0 0 87 0 0 0 0 87 0 0 0 0 87 0 0 0 0 87 0 0 0 0 87 0 0 0 0 87 0 0 0 0 87 0 0 0 0 87 0 0 0 0 87 0 0 0 0 87 0 0 0 0 87 0 0 0 0 87 0 0 0 0 87 0 0 0 0 87 0 0 0 0 87 0 0 0 0 87 0 0 0 0 87 0 0 0 0 87 0 0 0 0 87 0 0 0 0 87 0 0 0 0 87 0 0 0 0 87 0 0 0 0 87 0 0 0 0 87 0 0 0 0 87 0 0 0 0 87 0 0 0 0 87 0 0 0 0 87 0 0 0 0 87 0 0 0 0 87 0 0 0 0 87 0 0 0 0 87 0 0 0 0 87 0 0 0 0 87 0 0 0 0 87 0 0 0 0 87 0 0 0 0 87 0 0 0 0 
87 0 0 0 0 87 0 0 0 0 87 0 0 0 0 87 0 0 0 0 87 0 0 0 0 87 0 0 0 0 87 0 0 0 0 87 0 0 0 0 87 0 0 0 0 87 0 0 0 0 87 0 0 0 0 87 0 0 0 0 87 0 0 0 0 87 0 0 0 0 87 0 0 0 0 87 0 0 0 0 87 0 0 0 0 87 0 0 0 0 87 0 0 0 0 87 0 0 0 0 87 0 0 0 0 87 0 0 0 0 87 0 0 0 0 87 0 0 0 0 87 0 0 0 0 87 0 0 0 0 87 0 0 0 0 87 0 0 0 0 87 0 0 0 0 87 0 0 0 0 87 0 0 0 0 87 0 0 0 0 87 0 0 0 0 87 0 0 0 0 87 0 0 0 0 87 0 0 0 0 87 0 0 0 0 87 0 0 0 0 87 0 0 0 0 87 0 0 0 0 87 0 0 0 0 87 0 0 0 0 87 0 0 0 0 87 0 0 0 0 87 0 0 0 0 87 0 0 0 0 87 0 0 0 0 87 0 0 0 0 87 0 0 0 0 87 0 0 0 0 
87 0 0 0 0 87 0 0 0 0 87 0 0 0 0 87 0 0 0 0 87 0 0 0 0 87 0 0 0 0 87 0 0 0 0 87 0 0 0 0 87 0 0 0 0 87 0 0 0 0 87 0 0 0 0 87 0 0 0 0 87 0 0 0 0 87 0 0 0 0 87 0 0 0 0 87 0 0 0 0 87 0 0 0 0 87 0 0 0 0 87 0 0 0 0 87 0 0 0 0 87 0 0 0 0 87 0 0 0 0 87 0 0 0 0 87 0 0 0 0 87 0 0 0 0 87 0 0 0 0 87 0 0 0 0 87 0 0 0 0 87 0 0 0 0 87 0 0 0 0 87 0 0 0 0 87 0 0 0 0 87 0 0 0 0 87 0 0 0 0 87 0 0 0 0 87 0 0 0 0 87 0 0 0 0 87 0 0 0 0 87 0 0 0 0 87 0 0 0 0 87 0 0 0 0 87 0 0 0 0 87 0 0 0 0 87 0 0 0 0 87 0 0 0 0 87 0 0 0 0 87 0 0 0 0 87 0 0 0 0 87 0 0 0 0 87 0 0 0 0 
87 0 0 0 0 87 0 0 0 0 87 0 0 0 0 87 0 0 0 0 87 0 0 0 0 87 0 0 0 0 87 0 0 0 0 87 0 0 0 0 87 0 0 0 0 87 0 0 0 0 87 0 0 0 0 87 0 0 0 0 87 0 0 0 0 87 0 0 0 0 87 0 0 0 0 87 0 0 0 0 87 0 0 0 0 87 0 0 0 0 87 0 0 0 0 87 0 0 0 0 87 0 0 0 0 87 0 0 0 0 87 0 0 0 0 87 0 0 0 0 87 0 0 0 0 87 0 0 0 0 87 0 0 0 0 87 0 0 0 0 87 0 0 0 0 87 0 0 0 0 87 0 0 0 0 87 0 0 0 0 87 0 0 0 0 87 0 0 0 0 87 0 0 0 0 87 0 0 0 0 87 0 0 0 0 87 0 0 0 0 87 0 0 0 0 87 0 0 0 0 87 0 0 0 0 87 0 0 0 0 87 0 0 0 0 87 0 0 0 0 87 0 0 0 0 87 0 0 0 0 87 0 0 0 0 87 0 0 0 0 87 0 0 0 0 87 0 0 0 0 
87 0 0 0 0 87 0 0 0 0 87 0 0 0 0 87 0 0 0 0 87 0 0 0 0 87 0 0 0 0 87 0 0 0 0 87 0 0 0 0 87 0 0 0 0 87 0 0 0 0 87 0 0 0 0 87 0 0 0 0 87 0 0 0 0 87 0 0 0 0 87 0 0 0 0 87 0 0 0 0 87 0 0 0 0 87 0 0 0 0 87 0 0 0 0 87 0 0 0 0 87 0 0 0 0 87 0 0 0 0 87 0 0 0 0 87 0 0 0 0 87 0 0 0 0 87 0 0 0 0 87 0 0 0 0 87 0 0 0 0 87 0 0 0 0 87 0 0 0 0 87 0 0 0 0 87 0 0 0 0 87 0 0 0 0 87 0 0 0 0 87 0 0 0 0 87 0 0 0 0 87 0 0 0 0 87 0 0 0 0 87 0 0 0 0 87 0 0 0 0 87 0 0 0 0 87 0 0 0 0 87 0 0 0 0 87 0 0 0 0 87 0 0 0 0 87 0 0 0 0 87 0 0 0 0 87 0 0 0 0 87 0 0 0 0 87 0 0 0 0 
87 0 0 0 0 87 0 0 0 0 87 0 0 0 0 87 0 0 0 0 87 0 0 0 0 87 0 0 0 0 87 0 0 0 0 87 0 0 0 0 87 0 0 0 0 87 0 0 0 0 87 0 0 0 0 87 0 0 0 0 87 0 0 0 0 87 0 0 0 0 87 0 0 0 0 87 0 0 0 0 87 0 0 0 0 87 0 0 0 0 87 0 0 0 0 87 0 0 0 0 87 0 0 0 0 87 0 0 0 0 87 0 0 0 0 87 0 0 0 0 87 0 0 0 0 87 0 0 0 0 87 0 0 0 0 87 0 0 0 0 87 0 0 0 0 87 0 0 0 0 87 0 0 0 0 87 0 0 0 0 87 0 0 0 0 87 0 0 0 0 87 0 0 0 0 87 0 0 0 0 87 0 0 0 0 87 0 0 0 0 87 0 0 0 0 87 0 0 0 0 87 0 0 0 0 87 0 0 0 0 87 0 0 0 0 87 0 0 0 0 87 0 0 0 0 87 0 0 0 0 87 0 0 0 0 87 0 0 0 0 87 0 0 0 0 87 0 0 0 0 
87 0 0 0 0 87 0 0 0 0 87 0 0 0 0 87 0 0 0 0 87 0 0 0 0 87 0 0 0 0 87 0 0 0 0 87 0 0 0 0 87 0 0 0 0 87 0 0 0 0 87 0 0 0 0 87 0 0 0 0 87 0 0 0 0 87 0 0 0 0 87 0 0 0 0 87 0 0 0 0 87 0 0 0 0 87 0 0 0 0 87 0 0 0 0 87 0 0 0 0 87 0 0 0 0 87 0 0 0 0 87 0 0 0 0 87 0 0 0 0 87 0 0 0 0 87 0 0 0 0 87 0 0 0 0 87 0 0 0 0 87 0 0 0 0 87 0 0 0 0 87 0 0 0 0 87 0 0 0 0 87 0 0 0 0 87 0 0 0 0 87 0 0 0 0 87 0 0 0 0 87 0 0 0 0 87 0 0 0 0 87 0 0 0 0 87 0 0 0 0 87 0 0 0 0 87 0 0 0 0 87 0 0 0 0 87 0 0 0 0 87 0 0 0 0 87 0 0 0 0 87 0 0 0 0 87 0 0 0 0 87 0 0 0 0 87 0 0 0 0 
87 0 0 0 0 87 0 0 0 0 87 0 0 0 0 87 0 0 0 0 87 0 0 0 0 87 0 0 0 0 87 0 0 0 0 87 0 0 0 0 87 0 0 0 0 87 0 0 0 0 87 0 0 0 0 87 0 0 0 0 87 0 0 0 0 87 0 0 0 0 87 0 0 0 0 87 0 0 0 0 87 0 0 0 0 87 0 0 0 0 87 0 0 0 0 87 0 0 0 0 87 0 0 0 0 87 0 0 0 0 87 0 0 0 0 87 0 0 0 0 87 0 0 0 0 87 0 0 0 0 87 0 0 0 0 87 0 0 0 0 87 0 0 0 0 87 0 0 0 0 87 0 0 0 0 87 0 0 0 0 87 0 0 0 0 87 0 0 0 0 87 0 0 0 0 87 0 0 0 0 87 0 0 0 0 87 0 0 0 0 87 0 0 0 0 87 0 0 0 0 87 0 0 0 0 87 0 0 0 0 87 0 0 0 0 87 0 0 0 0 87 0 0 0 0 87 0 0 0 0 87 0 0 0 0 87 0 0 0 0 87 0 0 0 0 87 0 0 0 0 
87 0 0 0 0 87 0 0 0 0 87 0 0 0 0 87 0 0 0 0 87 0 0 0 0 87 0 0 0 0 87 0 0 0 0 87 0 0 0 0 87 0 0 0 0 87 0 0 0 0 87 0 0 0 0 87 0 0 0 0 87 0 0 0 0 87 0 0 0 0 87 0 0 0 0 87 0 0 0 0 87 0 0 0 0 87 0 0 0 0 87 0 0 0 0 87 0 0 0 0 87 0 0 0 0 87 0 0 0 0 87 0 0 0 0 87 0 0 0 0 87 0 0 0 0 87 0 0 0 0 87 0 0 0 0 87 0 0 0 0 87 0 0 0 0 87 0 0 0 0 87 0 0 0 0 87 0 0 0 0 87 0 0 0 0 87 0 0 0 0 87 0 0 0 0 87 0 0 0 0 87 0 0 0 0 87 0 0 0 0 87 0 0 0 0 87 0 0 0 0 87 0 0 0 0 87 0 0 0 0 87 0 0 0 0 87 0 0 0 0 87 0 0 0 0 87 0 0 0 0 87 0 0 0 0 87 0 0 0 0 87 0 0 0 0 87 0 0 0 0 
87 0 0 0 0 87 0 0 0 0 87 0 0 0 0 87 0 0 0 0 87 0 0 0 0 87 0 0 0 0 87 0 0 0 0 87 0 0 0 0 87 0 0 0 0 87 0 0 0 0 87 0 0 0 0 87 0 0 0 0 87 0 0 0 0 87 0 0 0 0 87 0 0 0 0 87 0 0 0 0 87 0 0 0 0 87 0 0 0 0 87 0 0 0 0 87 0 0 0 0 87 0 0 0 0 87 0 0 0 0 87 0 0 0 0 87 0 0 0 0 87 0 0 0 0 87 0 0 0 0 87 0 0 0 0 87 0 0 0 0 87 0 0 0 0 87 0 0 0 0 87 0 0 0 0 87 0 0 0 0 87 0 0 0 0 87 0 0 0 0 87 0 0 0 0 87 0 0 0 0 87 0 0 0 0 87 0 0 0 0 87 0 0 0 0 87 0 0 0 0 87 0 0 0 0 87 0 0 0 0 87 0 0 0 0 87 0 0 0 0 87 0 0 0 0 87 0 0 0 0 87 0 0 0 0 87 0 0 0 0 87 0 0 0 0 87 0 0 0 0 
87 0 0 0 0 87 0 0 0 0 87 0 0 0 0 87 0 0 0 0 87 0 0 0 0 87 0 0 0 0 87 0 0 0 0 87 0 0 0 0 87 0 0 0 0 87 0 0 0 0 87 0 0 0 0 87 0 0 0 0 87 0 0 0 0 87 0 0 0 0 87 0 0 0 0 87 0 0 0 0 87 0 0 0 0 87 0 0 0 0 87 0 0 0 0 87 0 0 0 0 87 0 0 0 0 87 0 0 0 0 87 0 0 0 0 87 0 0 0 0 87 0 0 0 0 87 0 0 0 0 87 0 0 0 0 87 0 0 0 0 87 0 0 0 0 87 0 0 0 0 87 0 0 0 0 87 0 0 0 0 87 0 0 0 0 87 0 0 0 0 87 0 0 0 0 87 0 0 0 0 87 0 0 0 0 87 0 0 0 0 87 0 0 0 0 87 0 0 0 0 87 0 0 0 0 87 0 0 0 0 87 0 0 0 0 87 0 0 0 0 87 0 0 0 0 87 0 0 0 0 87 0 0 0 0 87 0 0 0 0 87 0 0 0 0 87 0 0 0 0 
87 0 0 0 0 87 0 0 0 0 87 0 0 0 0 87 0 0 0 0 87 0 0 0 0 87 0 0 0 0 87 0 0 0 0 87 0 0 0 0 87 0 0 0 0 87 0 0 0 0 87 0 0 0 0 87 0 0 0 0 87 0 0 0 0 87 0 0 0 0 87 0 0 0 0 87 0 0 0 0 87 0 0 0 0 87 0 0 0 0 87 0 0 0 0 87 0 0 0 0 87 0 0 0 0 87 0 0 0 0 87 0 0 0 0 87 0 0 0 0 87 0 0 0 0 87 0 0 0 0 87 0 0 0 0 87 0 0 0 0 87 0 0 0 0 87 0 0 0 0 87 0 0 0 0 87 0 0 0 0 87 0 0 0 0 87 0 0 0 0 87 0 0 0 0 87 0 0 0 0 87 0 0 0 0 87 0 0 0 0 87 0 0 0 0 87 0 0 0 0 87 0 0 0 0 87 0 0 0 0 87 0 0 0 0 87 0 0 0 0 87 0 0 0 0 87 0 0 0 0 87 0 0 0 0 87 0 0 0 0 87 0 0 0 0 87 0 0 0 0 