40 40
87 0 0 0 0 87 0 0 0 0 87 0 0 0 0 87 0 0 0 0 87 0 0 0 0 87 0 0 0 0 87 0 0 0 0 87 0 0 0 0 87 0 0 0 0 87 0 0 0 0 87 0 0 0 0 87 0 0 0 0 87 0 0 0 0 87 0 0 0 0 87 0 0 0 0 87 0 0 0 0 87 0 0 0 0 87 0 0 0 0 87 0 0 0 0 87 0 0 0 0 87 0 0 0 0 87 0 0 0 0 87 0 0 0 0 87 0 0 0 0 87 0 0 0 0 87 0 0 0 0 87 0 0 0 0 87 0 0 0 0 87 0 0 0 0 87 0 0 0 0 87 0 0 0 0 87 0 0 0 0 87 0 0 0 0 87 0 0 0 0 87 0 0 0 0 87 0 0 0 0 87 0 0 0 0 87 0 0 0 0 87 0 0 0 0 87 0 0 0 0 
87 0 0 0 0 87 0 0 0 0 87 0 0 0 0 87 0 0 0 0 87 0 0 0 0 87 0 0 0 0 87 0 0 0 0 87 0 0 0 0 87 0 0 0 0 87 0 0 0 0 87 0 0 0 0 87 0 0 0 0 87 0 0 0 0 87 0 0 0 0 87 0 0 0 0 87 0 0 0 0 87 0 0 0 0 87 0 0 0 0 87 0 0 0 0 87 0 0 0 0 87 0 0 0 0 87 0 0 0 0 87 0 0 0 0 87 0 0 0 0 87 0 0 0 0 87 0 0 0 0 87 0 0 0 0 87 0 0 0 0 87 0 0 0 0 87 0 0 0 0 87 0 0 0 0 87 0 0 0 0 87 0 0 0 0 87 0 0 0 0 87 0 0 0 0 87 0 0 0 0 87 0 0 0 0 87 0 0 0 0 87 0 0 0 0 87 0 0 0 0 
87 0 0 0 0 87 0 0 0 0 87 0 0 0 0 87 0 0 0 0 87 0 0 0 0 87 0 0 0 0 87 0 0 0 0 87 0 0 0 0 87 0 0 0 0 87 0 0 0 0 87 0 0 0 0 87 0 0 0 0 87 0 0 0 0 87 0 0 0 0 87 0 0 0 0 87 0 0 0 0 87 0 0 0 0 87 0 0 0 0 87 0 0 0 0 87 0 0 0 0 87 0 0 0 0 87 0 0 0 0 87 0 0 0 0 87 0 0 0 0 87 0 0 0 0 87 0 0 0 0 87 0 0 0 0 87 0 0 0 0 87 0 0 0 0 87 0 0 0 0 87 0 0 0 0 87 0 0 0 0 87 0 0 0 0 87 0 0 0 0 87 0 0 0 0 87 0 0 0 0 87 0 0 0 0 87 0 0 0 0 87 0 0 0 0 87 0 0 0 0 
87 0 0 0 0 87 0 0 0 0 87 0 0 0 0 87 0 0 0 0 87 0 0 0 0 87 0 0 0 0 87 0 0 0 0 87 0 0 0 0 87 0 0 0 0 87 0 0 0 0 87 0 0 0 0 87 0 0 0 0 87 0 0 0 0 87 0 0 0 0 87 0 0 0 0 87 0 0 0 0 87 0 0 0 0 87 0 0 0 0 87 0 0 0 0 87 0 0 0 0 87 0 0 0 0 87 0 0 0 0 87 0 0 0 0 87 0 0 0 0 87 0 0 0 0 87 0 0 0 0 87 0 0 0 0 87 0 0 0 0 87 0 0 0 0 87 0 0 0 0 87 0 0 0 0 87 0 0 0 0 87 0 0 0 0 87 0 0 0 0 87 0 0 0 0 87 0 0 0 0 87 0 0 0 0 87 0 0 0 0 87 0 0 0 0 87 0 0 0 0 
87 0 0 0 0 87 0 0 0 0 87 0 0 0 0 87 0 0 0 0 87 0 0 0 0 87 0 0 0 0 87 0 0 0 0 87 0 0 0 0 87 0 0 0 0 87 0 0 0 0 87 0 0 0 0 87 0 0 0 0 87 0 0 0 0 87 0 0 0 0 87 0 0 0 0 87 0 0 0 0 87 0 0 0 0 87 0 0 0 0 87 0 0 0 0 87 0 0 0 0 87 0 0 0 0 87 0 0 0 0 87 0 0 0 0 87 0 0 0 0 87 0 0 0 0 87 0 0 0 0 87 0 0 0 0 87 0 0 0 0 87 0 0 0 0 87 0 0 0 0 87 0 0 0 0 87 0 0 0 0 87 0 0 0 0 87 0 0 0 0 87 0 0 0 0 87 0 0 0 0 87 0 0 0 0 87 0 0 0 0 87 0 0 0 0 87 0 0 0 0 
87 0 0 0 0 87 0 0 0 0 87 0 0 0 0 87 0 0 0 0 87 0 0 0 0 87 0 0 0 0 87 0 0 0 0 87 0 0 0 0 87 0 0 0 0 87 0 0 0 0 87 0 0 0 0 87 0 0 0 0 87 0 0 0 0 87 0 0 0 0 87 0 0 0 0 87 0 0 0 0 87 0 0 0 0 87 0 0 0 0 87 0 0 0 0 87 0 0 0 0 87 0 0 0 0 87 0 0 0 0 87 0 0 0 0 87 0 0 0 0 87 0 0 0 0 87 0 0 0 0 87 0 0 0 0 87 0 0 0 0 87 0 0 0 0 87 0 0 0 0 87 0 0 0 0 87 0 0 0 0 87 0 0 0 0 87 0 0 0 0 87 0 0 0 0 87 0 0 0 0 87 0 0 0 0 87 0 0 0 0 87 0 0 0 0 87 0 0 0 0 
87 0 0 0 0 87 0 0 0 0 87 0 0 0 0 87 0 0 0 0 87 0 0 0 0 87 0 0 0 0 87 0 0 0 0 87 0 0 0 0 87 0 0 0 0 87 0 0 0 0 87 0 0 0 0 87 0 0 0 0 87 0 0 0 0 87 0 0 0 0 87 0 0 0 0 87 0 0 0 0 87 0 0 0 0 87 0 0 0 0 87 0 0 0 0 87 0 0 0 0 87 0 0 0 0 87 0 0 0 0 87 0 0 0 0 87 0 0 0 0 87 0 0 0 0 87 0 0 0 0 87 0 0 0 0 87 0 0 0 0 87 0 0 0 0 87 0 0 0 0 87 0 0 0 0 87 0 0 0 0 87 0 0 0 0 87 0 0 0 0 87 0 0 0 0 87 0 0 0 0 87 0 0 0 0 87 0 0 0 0 87 0 0 0 0 87 0 0 0 0 
87 0 0 0 0 87 0 0 0 0 87 0 0 0 0 87 0 0 0 0 87 0 0 0 0 87 0 0 0 0 87 0 0 0 0 87 0 0 0 0 87 0 0 0 0 87 0 0 0 0 87 0 0 0 0 87 0 0 0 0 87 0 0 0 0 87 0 0 0 0 87 0 0 0 0 87 0 0 0 0 87 0 0 0 0 87 0 0 0 0 87 0 0 0 0 87 0 0 0 0 87 0 0 0 0 87 0 0 0 0 87 0 0 0 0 87 0 0 0 0 87 0 0 0 0 87 0 0 0 0 87 0 0 0 0 87 0 0 0 0 87 0 0 0 0 87 0 0 0 0 87 0 0 0 0 87 0 0 0 0 87 0 0 0 0 87 0 0 0 0 87 0 0 0 0 87 0 0 0 0 87 0 0 0 0 87 0 0 0 0 87 0 0 0 0 87 0 0 0 0 
87 0 0 0 0 87 0 0 0 0 87 0 0 0 0 87 0 0 0 0 87 0 0 0 0 87 0 0 0 0 87 0 0 0 0 87 0 0 0 0 87 0 0 0 0 87 0 0 0 0 87 0 0 0 0 87 0 0 0 0 87 0 0 0 0 87 0 0 0 0 87 0 0 0 0 87 0 0 0 0 87 0 0 0 0 87 0 0 0 0 87 0 0 0 0 87 0 0 0 0 87 0 0 0 0 87 0 0 0 0 87 0 0 0 0 87 0 0 0 0 87 0 0 0 0 87 0 0 0 0 87 0 0 0 0 87 0 0 0 0 87 0 0 0 0 87 0 0 0 0 87 0 0 0 0 87 0 0 0 0 87 0 0 0 0 87 0 0 0 0 87 0 0 0 0 87 0 0 0 0 87 0 0 0 0 87 0 0 0 0 87 0 0 0 0 87 0 0 0 0 
87 0 0 0 0 87 0 0 0 0 87 0 0 0 0 87 0 0 0 0 87 0 0 0 0 87 0 0 0 0 87 0 0 0 0 87 0 0 0 0 87 0 0 0 0 87 0 0 0 0 87 0 0 0 0 87 0 0 0 0 87 0 0 0 0 87 0 0 0 0 87 0 0 0 0 87 0 0 0 0 87 0 0 0 0 87 0 0 0 0 87 0 0 0 0 87 0 0 0 0 87 0 0 0 0 87 0 0 0 0 87 0 0 0 0 87 0 0 0 0 87 0 0 0 0 87 0 0 0 0 87 0 0 0 0 87 0 0 0 0 87 0 0 0 0 87 0 0 0 0 87 0 0 0 0 87 0 0 0 0 87 0 0 0 0 87 0 0 0 0 87 0 0 0 0 87 0 0 0 0 87 0 0 0 0 87 0 0 0 0 87 0 0 0 0 87 0 0 0 0 
87 0 0 0 0 87 0 0 0 0 87 0 0 0 0 87 0 0 0 0 87 0 0 0 0 87 0 0 0 0 87 0 0 0 0 87 0 0 0 0 87 0 0 0 0 87 0 0 0 0 87 0 0 0 0 87 0 0 0 0 87 0 0 0 0 87 0 0 0 0 87 0 0 0 0 87 0 0 0 0 87 0 0 0 0 87 0 0 0 0 87 0 0 0 0 87 0 0 0 0 87 0 0 0 0 87 0 0 0 0 87 0 0 0 0 87 0 0 0 0 87 0 0 0 0 87 0 0 0 0 87 0 0 0 0 87 0 0 0 0 87 0 0 0 0 87 0 0 0 0 87 0 0 0 0 87 0 0 0 0 87 0 0 0 0 87 0 0 0 0 87 0 0 0 0 87 0 0 0 0 87 0 0 0 0 87 0 0 0 0 87 0 0 0 0 87 0 0 0 0 
87 0 0 0 0 87 0 0 0 0 87 0 0 0 0 87 0 0 0 0 87 0 0 0 0 87 0 0 0 0 87 0 0 0 0 87 0 0 0 0 87 0 0 0 0 87 0 0 0 0 87 0 0 0 0 87 0 0 0 0 87 0 0 0 0 87 0 0 0 0 87 0 0 0 0 87 0 0 0 0 87 0 0 0 0 87 0 0 0 0 87 0 0 0 0 87 0 0 0 0 87 0 0 0 0 87 0 0 0 0 87 0 0 0 0 87 0 0 0 0 87 0 0 0 0 87 0 0 0 0 87 0 0 0 0 87 0 0 0 0 87 0 0 0 0 87 0 0 0 0 87 0 0 0 0 87 0 0 0 0 87 0 0 0 0 87 0 0 0 0 87 0 0 0 0 87 0 0 0 0 87 0 0 0 0 87 0 0 0 0 87 0 0 0 0 87 0 0 0 0 
87 0 0 0 0 87 0 0 0 0 87 0 0 0 0 87 0 0 0 0 87 0 0 0 0 87 0 0 0 0 87 0 0 0 0 87 0 0 0 0 87 0 0 0 0 87 0 0 0 0 87 0 0 0 0 87 0 0 0 0 87 0 0 0 0 87 0 0 0 0 87 0 0 0 0 87 0 0 0 0 87 0 0 0 0 87 0 0 0 0 87 0 0 0 0 87 0 0 0 0 87 0 0 0 0 87 0 0 0 0 87 0 0 0 0 87 0 0 0 0 87 0 0 0 0 87 0 0 0 0 87 0 0 0 0 332 0 0 0 0 87 0 0 0 0 87 0 0 0 0 87 0 0 0 0 87 0 0 0 0 87 0 0 0 0 87 0 0 0 0 87 0 0 0 0 87 0 0 0 0 87 0 0 0 0 87 0 0 0 0 87 0 0 0 0 87 0 0 0 0 
87 0 0 0 0 87 0 0 0 0 87 0 0 0 0 87 0 0 0 0 87 0 0 0 0 87 0 0 0 0 87 0 0 0 0 87 0 0 0 0 87 0 0 0 0 87 0 0 0 0 87 0 0 0 0 87 0 0 0 0 87 0 0 0 0 87 0 0 0 0 87 0 0 0 0 87 0 0 0 0 87 0 0 0 0 87 0 0 0 0 87 0 0 0 0 87 0 0 0 0 87 0 0 0 0 87 0 0 0 0 87 0 0 0 0 87 0 0 0 0 87 0 0 0 0 87 0 0 0 0 87 0 0 0 0 87 0 0 0 0 87 0 0 0 0 87 0 0 0 0 87 0 0 0 0 87 0 0 0 0 87 0 0 0 0 87 0 0 0 0 87 0 0 0 0 87 0 0 0 0 87 0 0 0 0 87 0 0 0 0 87 0 0 0 0 87 0 0 0 0 
87 0 0 0 0 87 0 0 0 0 87 0 0 0 0 87 0 0 0 0 87 0 0 0 0 87 0 0 0 0 87 0 0 0 0 87 0 0 0 0 87 0 0 0 0 87 0 0 0 0 348 0 0 0 0 349 0 0 0 0 87 0 0 0 0 87 0 0 0 0 87 0 0 0 0 87 0 0 0 0 87 0 0 0 0 87 0 0 0 0 87 0 0 0 0 347 0 0 0 0 87 0 0 0 0 87 0 0 0 0 87 0 0 0 0 87 0 0 0 0 87 0 0 0 0 87 0 0 0 0 87 0 0 0 0 324 0 0 0 0 325 0 0 0 0 326 0 0 0 0 87 0 0 0 0 87 0 0 0 0 87 0 0 0 0 87 0 0 0 0 87 0 0 0 0 87 0 0 0 0 87 0 0 0 0 87 0 0 0 0 87 0 0 0 0 87 0 0 0 0 
87 0 0 0 0 87 0 0 0 0 87 0 0 0 0 87 0 0 0 0 87 0 0 0 0 87 0 0 0 0 329 0 0 0 0 87 0 0 0 0 87 0 0 0 0 87 0 0 0 0 87 0 0 0 0 87 0 0 0 0 87 0 0 0 0 87 0 0 0 0 87 0 0 0 0 87 0 0 0 0 87 0 0 0 0 87 0 0 0 0 87 0 0 0 0 87 0 0 0 0 87 0 0 0 0 87 0 0 0 0 87 0 0 0 0 87 0 0 0 0 337 0 0 0 0 87 0 0 0 0 87 0 0 0 0 334 0 0 0 0 335 0 0 0 0 336 0 0 0 0 87 0 0 0 0 87 0 0 0 0 87 0 0 0 0 87 0 0 0 0 87 0 0 0 0 87 0 0 0 0 87 0 0 0 0 87 0 0 0 0 87 0 0 0 0 87 0 0 0 0 
87 0 0 0 0 87 0 0 0 0 87 0 0 0 0 87 0 0 0 0 87 0 0 0 0 87 0 0 0 0 87 0 0 0 0 87 0 0 0 0 87 0 0 0 0 87 0 0 0 0 87 0 0 0 0 87 0 0 0 0 87 0 0 0 0 87 0 0 0 0 87 0 0 0 0 87 0 0 0 0 87 0 0 0 0 87 0 0 0 0 87 0 0 0 0 87 0 0 0 0 87 0 0 0 0 87 0 0 0 0 87 0 0 0 0 87 0 0 0 0 87 0 0 0 0 87 0 0 0 0 87 0 0 0 0 344 0 0 0 0 345 0 0 0 0 346 0 0 0 0 87 0 0 0 0 87 0 0 0 0 87 0 0 0 0 332 0 0 0 0 87 0 0 0 0 87 0 0 0 0 87 0 0 0 0 87 0 0 0 0 87 0 0 0 0 87 0 0 0 0 
87 0 0 0 0 87 0 0 0 0 87 0 0 0 0 87 0 0 0 0 87 0 0 0 0 87 0 0 0 0 87 0 0 0 0 87 0 0 0 0 87 0 0 0 0 87 0 0 0 0 87 0 0 0 0 87 0 0 0 0 87 0 0 0 0 87 0 0 0 0 87 0 0 0 0 333 0 0 0 0 87 0 0 0 0 87 0 0 0 0 87 0 0 0 0 87 0 0 0 0 87 0 0 0 0 327 0 0 0 0 87 0 0 0 0 87 0 0 0 0 87 0 0 0 0 87 0 0 0 0 87 0 0 0 0 87 0 0 0 0 87 0 0 0 0 87 0 0 0 0 87 0 0 0 0 87 0 0 0 0 87 0 0 0 0 87 0 0 0 0 87 0 0 0 0 87 0 0 0 0 87 0 0 0 0 87 0 0 0 0 87 0 0 0 0 87 0 0 0 0 
87 0 0 0 0 328 0 0 0 0 87 0 0 0 0 87 0 0 0 0 87 0 0 0 0 87 0 0 0 0 87 0 0 0 0 87 0 0 0 0 87 0 0 0 0 333 0 0 0 0 87 0 0 0 0 87 0 0 0 0 87 0 0 0 0 87 0 0 0 0 87 0 0 0 0 87 0 0 0 0 339 0 0 0 0 87 0 0 0 0 87 0 0 0 0 87 0 0 0 0 87 0 0 0 0 87 0 0 0 0 87 0 0 0 0 87 0 0 0 0 87 0 0 0 0 87 0 0 0 0 87 0 0 0 0 87 0 0 0 0 87 0 0 0 0 87 0 0 0 0 87 0 0 0 0 87 0 0 0 0 87 0 0 0 0 87 0 0 0 0 87 0 0 0 0 87 0 0 0 0 87 0 0 0 0 87 0 0 0 0 87 0 0 0 0 87 0 0 0 0 
87 0 0 0 0 87 0 0 0 0 87 0 0 0 0 87 0 0 0 0 327 0 0 0 0 87 0 0 0 0 87 0 0 0 0 87 0 0 0 0 87 0 0 0 0 87 0 0 0 0 87 0 0 0 0 87 0 0 0 0 87 0 0 0 0 87 0 0 0 0 87 0 0 0 0 87 0 0 0 0 87 0 0 0 0 87 0 0 0 0 87 0 0 0 0 87 0 0 0 0 87 0 0 0 0 87 0 0 0 0 87 0 0 0 0 337 0 0 0 0 87 0 0 0 0 87 0 0 0 0 87 0 0 0 0 339 0 0 0 0 87 0 0 0 0 87 0 0 0 0 87 0 0 0 0 332 0 0 0 0 87 0 0 0 0 87 0 0 0 0 87 0 0 0 0 87 0 0 0 0 87 0 0 0 0 87 0 0 0 0 87 0 0 0 0 87 0 0 0 0 
87 0 0 0 0 87 0 0 0 0 87 0 0 0 0 87 0 0 0 0 87 0 0 0 0 87 0 0 0 0 87 0 0 0 0 87 0 0 0 0 87 0 0 0 0 339 0 0 0 0 87 0 0 0 0 87 0 0 0 0 87 0 0 0 0 87 0 0 0 0 87 0 0 0 0 87 0 0 0 0 87 0 0 0 0 87 0 0 0 0 87 0 0 0 0 87 0 0 0 0 337 0 0 0 0 87 0 0 0 0 87 0 0 0 0 87 0 0 0 0 339 0 0 0 0 87 0 0 0 0 87 0 0 0 0 87 0 0 0 0 87 0 0 0 0 87 0 0 0 0 87 0 0 0 0 87 0 0 0 0 87 0 0 0 0 330 0 0 0 0 331 0 0 0 0 87 0 0 0 0 87 0 0 0 0 87 0 0 0 0 87 0 0 0 0 87 0 0 0 0 
87 0 0 0 0 87 0 0 0 0 87 0 0 0 0 87 0 0 0 0 87 0 0 0 0 87 0 0 0 0 87 0 0 0 0 337 0 0 0 0 87 0 0 0 0 87 0 0 0 0 87 0 0 0 0 87 0 0 0 0 339 0 0 0 0 87 0 0 0 0 87 0 0 0 0 87 0 0 0 0 87 0 0 0 0 324 0 0 0 0 325 0 0 0 0 326 0 0 0 0 87 0 0 0 0 87 0 0 0 0 87 0 0 0 0 87 0 0 0 0 87 0 0 0 0 87 0 0 0 0 87 0 0 0 0 87 0 0 0 0 87 0 0 0 0 87 0 0 0 0 87 0 0 0 0 87 0 0 0 0 87 0 0 0 0 340 0 0 0 0 341 0 0 0 0 87 0 0 0 0 87 0 0 0 0 87 0 0 0 0 87 0 0 0 0 87 0 0 0 0 
87 0 0 0 0 87 0 0 0 0 87 0 0 0 0 87 0 0 0 0 87 0 0 0 0 87 0 0 0 0 87 0 0 0 0 87 0 0 0 0 87 0 0 0 0 87 0 0 0 0 87 0 0 0 0 87 0 0 0 0 87 0 0 0 0 87 0 0 0 0 332 0 0 0 0 87 0 0 0 0 87 0 0 0 0 334 0 0 0 0 335 0 0 0 0 336 0 0 0 0 87 0 0 0 0 332 0 0 0 0 87 0 0 0 0 87 0 0 0 0 87 0 0 0 0 87 0 0 0 0 87 0 0 0 0 87 0 0 0 0 87 0 0 0 0 338 0 0 0 0 87 0 0 0 0 87 0 0 0 0 87 0 0 0 0 87 0 0 0 0 87 0 0 0 0 87 0 0 0 0 87 0 0 0 0 87 0 0 0 0 87 0 0 0 0 87 0 0 0 0 
87 0 0 0 0 339 0 0 0 0 87 0 0 1 0 87 0 0 1 0 87 0 0 1 0 87 0 0 0 0 87 0 0 0 0 87 0 0 0 0 87 0 0 0 0 87 0 0 0 0 87 0 0 0 0 348 0 0 0 0 349 0 0 0 0 87 0 0 0 0 87 0 0 0 0 87 0 0 0 0 87 0 0 0 0 344 0 0 0 0 345 0 0 0 0 346 0 0 0 0 87 0 0 0 0 87 0 0 0 0 87 0 0 0 0 87 0 0 0 0 87 0 0 0 0 333 0 0 0 0 87 0 0 0 0 87 0 0 0 0 87 0 0 0 0 87 0 0 0 0 87 0 0 0 0 87 0 0 0 0 87 0 0 0 0 87 0 0 0 0 87 0 0 0 0 87 0 0 0 0 87 0 0 0 0 87 0 0 0 0 87 0 0 0 0 87 0 0 0 0 
87 0 0 1 0 87 0 0 1 0 96 0 0 0 0 96 0 0 0 0 96 0 0 0 0 332 0 0 1 0 87 0 0 1 0 87 0 0 1 0 87 0 0 1 0 87 0 0 0 0 87 0 0 0 0 87 0 0 0 0 87 0 0 0 0 87 0 0 0 0 87 0 0 0 0 87 0 0 0 0 87 0 0 0 0 87 0 0 0 0 87 0 0 0 0 87 0 0 0 0 87 0 0 0 0 87 0 0 0 0 87 0 0 0 0 87 0 0 0 0 87 0 0 0 0 87 0 0 0 0 87 0 0 0 0 87 0 0 0 0 87 0 0 0 0 87 0 0 0 0 332 0 0 0 0 87 0 0 0 0 87 0 0 0 0 87 0 0 0 0 333 0 0 0 0 87 0 0 0 0 87 0 0 0 0 87 0 0 0 0 87 0 0 0 0 87 0 0 0 0 
96 0 0 0 0 96 0 0 0 0 96 0 0 0 0 96 0 0 0 0 96 0 0 0 0 96 0 0 0 0 96 0 0 0 0 96 0 0 0 0 96 0 0 0 0 87 0 0 1 0 328 0 0 1 0 87 0 0 1 0 87 0 0 1 0 87 0 0 1 0 87 0 0 1 0 87 0 0 1 0 87 0 0 1 0 87 0 0 1 0 332 0 0 1 0 87 0 0 1 0 87 0 0 1 0 87 0 0 1 0 87 0 0 1 0 87 0 0 1 0 87 0 0 1 0 87 0 0 1 0 87 0 0 1 0 87 0 0 1 0 87 0 0 1 0 87 0 0 1 0 87 0 0 1 0 87 0 0 1 0 87 0 0 1 0 87 0 0 1 0 87 0 0 1 0 87 0 0 1 0 87 0 0 1 0 87 0 0 1 0 87 0 0 1 0 87 0 0 0 0 
96 0 0 0 0 96 0 0 0 0 96 0 0 0 0 96 0 0 0 0 96 0 0 0 0 96 0 0 0 0 96 0 0 0 0 96 0 0 0 0 96 0 0 0 0 129 0 0 0 0 129 0 0 0 0 129 0 0 0 0 129 0 0 0 0 129 0 0 0 0 129 0 0 0 0 129 0 0 0 0 129 0 0 0 0 129 0 0 0 0 129 0 0 0 0 129 0 0 0 0 129 0 0 0 0 129 0 0 0 0 129 0 0 0 0 129 0 0 0 0 129 0 0 0 0 129 0 0 0 0 129 0 0 0 0 129 0 0 0 0 129 0 0 0 0 129 0 0 0 0 129 0 0 0 0 129 0 0 0 0 129 0 0 0 0 129 0 0 0 0 129 0 0 0 0 129 0 0 0 0 129 0 0 0 0 129 0 0 0 0 129 0 0 0 0 87 0 0 1 0 
96 0 0 0 0 96 0 0 0 0 96 0 0 0 0 96 0 0 0 0 96 0 0 0 0 96 0 0 0 0 96 0 0 0 0 96 0 0 0 0 96 0 0 0 0 87 0 0 1 0 87 0 0 1 0 87 0 0 1 0 87 0 0 1 0 87 0 0 1 0 87 0 0 1 0 87 0 0 1 0 337 0 0 1 0 87 0 0 1 0 87 0 0 1 0 87 0 0 1 0 87 0 0 1 0 87 0 0 1 0 87 0 0 1 0 87 0 0 1 0 87 0 0 1 0 87 0 0 1 0 332 0 0 1 0 87 0 0 1 0 87 0 0 1 0 87 0 0 1 0 87 0 0 1 0 87 0 0 1 0 87 0 0 1 0 87 0 0 1 0 87 0 0 1 0 87 0 0 1 0 87 0 0 1 0 87 0 0 1 0 87 0 0 1 0 87 0 0 0 0 
98 0 0 1 0 98 0 0 1 0 96 0 0 0 0 96 0 0 0 0 96 0 0 0 0 98 0 0 1 0 98 0 0 1 0 98 0 0 1 0 98 0 0 1 0 332 0 0 0 0 87 0 0 0 0 87 0 0 0 0 87 0 0 0 0 327 0 0 0 0 87 0 0 0 0 87 0 0 0 0 87 0 0 0 0 87 0 0 0 0 87 0 0 0 0 87 0 0 0 0 87 0 0 0 0 332 0 0 0 0 87 0 0 0 0 87 0 0 0 0 87 0 0 0 0 87 0 0 0 0 87 0 0 0 0 87 0 0 0 0 87 0 0 0 0 332 0 0 0 0 87 0 0 0 0 87 0 0 0 0 87 0 0 0 0 87 0 0 0 0 87 0 0 0 0 87 0 0 0 0 87 0 0 0 0 339 0 0 0 0 87 0 0 0 0 87 0 0 0 0 
87 0 0 0 0 87 0 0 0 0 98 0 0 1 0 98 0 0 1 0 98 0 0 1 0 87 0 0 0 0 87 0 0 0 0 87 0 0 0 0 87 0 0 0 0 87 0 0 0 0 87 0 0 0 0 87 0 0 0 0 87 0 0 0 0 87 0 0 0 0 87 0 0 0 0 87 0 0 0 0 87 0 0 0 0 87 0 0 0 0 87 0 0 0 0 338 0 0 0 0 87 0 0 0 0 87 0 0 0 0 87 0 0 0 0 87 0 0 0 0 328 0 0 0 0 87 0 0 0 0 87 0 0 0 0 347 0 0 0 0 87 0 0 0 0 87 0 0 0 0 87 0 0 0 0 87 0 0 0 0 87 0 0 0 0 87 0 0 0 0 87 0 0 0 0 87 0 0 0 0 87 0 0 0 0 87 0 0 0 0 87 0 0 0 0 87 0 0 0 0 
87 0 0 0 0 87 0 0 0 0 87 0 0 0 0 87 0 0 0 0 87 0 0 0 0 87 0 0 0 0 87 0 0 0 0 87 0 0 0 0 87 0 0 0 0 87 0 0 0 0 87 0 0 0 0 330 0 0 0 0 331 0 0 0 0 87 0 0 0 0 87 0 0 0 0 87 0 0 0 0 339 0 0 0 0 87 0 0 0 0 87 0 0 0 0 87 0 0 0 0 87 0 0 0 0 87 0 0 0 0 87 0 0 0 0 87 0 0 0 0 87 0 0 0 0 87 0 0 0 0 87 0 0 0 0 87 0 0 0 0 87 0 0 0 0 87 0 0 0 0 87 0 0 0 0 87 0 0 0 0 327 0 0 0 0 87 0 0 0 0 87 0 0 0 0 87 0 0 0 0 87 0 0 0 0 87 0 0 0 0 87 0 0 0 0 87 0 0 0 0 
87 0 0 0 0 87 0 0 0 0 87 0 0 0 0 87 0 0 0 0 347 0 0 0 0 87 0 0 0 0 87 0 0 0 0 337 0 0 0 0 87 0 0 0 0 87 0 0 0 0 87 0 0 0 0 340 0 0 0 0 341 0 0 0 0 87 0 0 0 0 87 0 0 0 0 87 0 0 0 0 87 0 0 0 0 87 0 0 0 0 87 0 0 0 0 87 0 0 0 0 87 0 0 0 0 87 0 0 0 0 87 0 0 0 0 87 0 0 0 0 87 0 0 0 0 87 0 0 0 0 87 0 0 0 0 87 0 0 0 0 87 0 0 0 0 87 0 0 0 0 87 0 0 0 0 87 0 0 0 0 87 0 0 0 0 87 0 0 0 0 87 0 0 0 0 87 0 0 0 0 87 0 0 0 0 87 0 0 0 0 87 0 0 0 0 87 0 0 0 0 
87 0 0 0 0 87 0 0 0 0 87 0 0 0 0 87 0 0 0 0 87 0 0 0 0 87 0 0 0 0 87 0 0 0 0 87 0 0 0 0 87 0 0 0 0 87 0 0 0 0 87 0 0 0 0 87 0 0 0 0 87 0 0 0 0 87 0 0 0 0 87 0 0 0 0 87 0 0 0 0 87 0 0 0 0 87 0 0 0 0 87 0 0 0 0 87 0 0 0 0 87 0 0 0 0 87 0 0 0 0 87 0 0 0 0 87 0 0 0 0 337 0 0 0 0 87 0 0 0 0 87 0 0 0 0 87 0 0 0 0 87 0 0 0 0 87 0 0 0 0 87 0 0 0 0 87 0 0 0 0 87 0 0 0 0 87 0 0 0 0 87 0 0 0 0 348 0 0 0 0 349 0 0 0 0 87 0 0 0 0 87 0 0 0 0 87 0 0 0 0 
87 0 0 0 0 87 0 0 0 0 87 0 0 0 0 87 0 0 0 0 87 0 0 0 0 87 0 0 0 0 87 0 0 0 0 87 0 0 0 0 87 0 0 0 0 337 0 0 0 0 87 0 0 0 0 87 0 0 0 0 87 0 0 0 0 87 0 0 0 0 87 0 0 0 0 87 0 0 0 0 87 0 0 0 0 87 0 0 0 0 87 0 0 0 0 87 0 0 0 0 87 0 0 0 0 87 0 0 0 0 347 0 0 0 0 87 0 0 0 0 87 0 0 0 0 87 0 0 0 0 87 0 0 0 0 87 0 0 0 0 87 0 0 0 0 87 0 0 0 0 87 0 0 0 0 87 0 0 0 0 87 0 0 0 0 87 0 0 0 0 87 0 0 0 0 87 0 0 0 0 87 0 0 0 0 87 0 0 0 0 87 0 0 0 0 87 0 0 0 0 
87 0 0 0 0 87 0 0 0 0 87 0 0 0 0 87 0 0 0 0 87 0 0 0 0 87 0 0 0 0 87 0 0 0 0 87 0 0 0 0 87 0 0 0 0 87 0 0 0 0 87 0 0 0 0 87 0 0 0 0 87 0 0 0 0 87 0 0 0 0 87 0 0 0 0 347 0 0 0 0 87 0 0 0 0 87 0 0 0 0 87 0 0 0 0 87 0 0 0 0 87 0 0 0 0 87 0 0 0 0 87 0 0 0 0 87 0 0 0 0 87 0 0 0 0 87 0 0 0 0 87 0 0 0 0 87 0 0 0 0 87 0 0 0 0 87 0 0 0 0 347 0 0 0 0 87 0 0 0 0 87 0 0 0 0 87 0 0 0 0 87 0 0 0 0 87 0 0 0 0 87 0 0 0 0 87 0 0 0 0 87 0 0 0 0 87 0 0 0 0 
87 0 0 0 0 87 0 0 0 0 87 0 0 0 0 87 0 0 0 0 87 0 0 0 0 87 0 0 0 0 87 0 0 0 0 87 0 0 0 0 87 0 0 0 0 87 0 0 0 0 87 0 0 0 0 87 0 0 0 0 87 0 0 0 0 87 0 0 0 0 87 0 0 0 0 87 0 0 0 0 87 0 0 0 0 87 0 0 0 0 87 0 0 0 0 337 0 0 0 0 87 0 0 0 0 87 0 0 0 0 87 0 0 0 0 87 0 0 0 0 87 0 0 0 0 87 0 0 0 0 329 0 0 0 0 87 0 0 0 0 87 0 0 0 0 87 0 0 0 0 87 0 0 0 0 87 0 0 0 0 87 0 0 0 0 87 0 0 0 0 87 0 0 0 0 328 0 0 0 0 87 0 0 0 0 87 0 0 0 0 87 0 0 0 0 87 0 0 0 0 
87 0 0 0 0 329 0 0 0 0 87 0 0 0 0 87 0 0 0 0 87 0 0 0 0 87 0 0 0 0 87 0 0 0 0 87 0 0 0 0 87 0 0 0 0 87 0 0 0 0 87 0 0 0 0 87 0 0 0 0 87 0 0 0 0 87 0 0 0 0 87 0 0 0 0 87 0 0 0 0 87 0 0 0 0 87 0 0 0 0 87 0 0 0 0 87 0 0 0 0 87 0 0 0 0 87 0 0 0 0 87 0 0 0 0 87 0 0 0 0 87 0 0 0 0 87 0 0 0 0 87 0 0 0 0 87 0 0 0 0 87 0 0 0 0 87 0 0 0 0 87 0 0 0 0 87 0 0 0 0 87 0 0 0 0 87 0 0 0 0 87 0 0 0 0 87 0 0 0 0 87 0 0 0 0 87 0 0 0 0 87 0 0 0 0 87 0 0 0 0 
87 0 0 0 0 87 0 0 0 0 87 0 0 0 0 87 0 0 0 0 87 0 0 0 0 87 0 0 0 0 87 0 0 0 0 87 0 0 0 0 329 0 0 0 0 87 0 0 0 0 87 0 0 0 0 87 0 0 0 0 87 0 0 0 0 87 0 0 0 0 87 0 0 0 0 87 0 0 0 0 87 0 0 0 0 87 0 0 0 0 87 0 0 0 0 87 0 0 0 0 87 0 0 0 0 87 0 0 0 0 87 0 0 0 0 87 0 0 0 0 87 0 0 0 0 347 0 0 0 0 87 0 0 0 0 87 0 0 0 0 87 0 0 0 0 87 0 0 0 0 87 0 0 0 0 87 0 0 0 0 87 0 0 0 0 87 0 0 0 0 87 0 0 0 0 87 0 0 0 0 87 0 0 0 0 87 0 0 0 0 87 0 0 0 0 87 0 0 0 0 
87 0 0 0 0 87 0 0 0 0 87 0 0 0 0 87 0 0 0 0 87 0 0 0 0 87 0 0 0 0 87 0 0 0 0 87 0 0 0 0 87 0 0 0 0 87 0 0 0 0 87 0 0 0 0 87 0 0 0 0 87 0 0 0 0 87 0 0 0 0 87 0 0 0 0 87 0 0 0 0 87 0 0 0 0 87 0 0 0 0 87 0 0 0 0 87 0 0 0 0 87 0 0 0 0 87 0 0 0 0 87 0 0 0 0 87 0 0 0 0 87 0 0 0 0 87 0 0 0 0 87 0 0 0 0 87 0 0 0 0 87 0 0 0 0 87 0 0 0 0 87 0 0 0 0 87 0 0 0 0 87 0 0 0 0 87 0 0 0 0 87 0 0 0 0 87 0 0 0 0 87 0 0 0 0 87 0 0 0 0 87 0 0 0 0 87 0 0 0 0 
87 0 0 0 0 87 0 0 0 0 87 0 0 0 0 87 0 0 0 0 87 0 0 0 0 87 0 0 0 0 87 0 0 0 0 87 0 0 0 0 87 0 0 0 0 87 0 0 0 0 87 0 0 0 0 87 0 0 0 0 87 0 0 0 0 87 0 0 0 0 87 0 0 0 0 87 0 0 0 0 87 0 0 0 0 87 0 0 0 0 87 0 0 0 0 87 0 0 0 0 87 0 0 0 0 87 0 0 0 0 87 0 0 0 0 87 0 0 0 0 87 0 0 0 0 87 0 0 0 0 87 0 0 0 0 87 0 0 0 0 87 0 0 0 0 87 0 0 0 0 87 0 0 0 0 87 0 0 0 0 87 0 0 0 0 87 0 0 0 0 87 0 0 0 0 87 0 0 0 0 87 0 0 0 0 87 0 0 0 0 87 0 0 0 0 87 0 0 0 0 