22 22
16 00 00 1 1 16 00 00 1 0 16 00 00 1 0 16 00 00 1 0 16 00 00 1 0 16 00 00 1 0 16 00 00 1 0 16 00 00 1 0 16 00 00 1 0 16 00 00 1 0 16 00 00 1 0 16 00 00 1 0 16 00 00 1 0 16 00 00 1 0 16 00 00 1 0 16 00 00 1 0 16 00 00 1 0 16 00 00 1 0 16 00 00 1 0 16 00 00 1 0 16 00 00 1 0 16 00 00 1 0
16 00 00 1 1 16 12 00 0 0 16 10 00 0 0 16 10 00 0 0 16 10 00 0 0 16 10 00 0 0 16 10 00 0 0 16 10 00 0 0 16 10 00 0 0 16 10 00 0 0 16 10 00 0 0 16 10 00 0 0 16 10 00 0 0 16 10 00 0 0 16 10 00 0 0 16 10 00 0 0 16 10 00 0 0 16 10 00 0 0 16 10 00 0 0 16 10 00 0 0 16 13 00 0 0 16 00 00 1 0
16 00 00 1 1 16 08 00 0 0 01 00 00 0 0 01 00 00 0 0 01 00 00 0 0 02 00 00 0 0 01 00 00 0 0 01 00 00 0 0 01 00 00 0 0 01 00 00 0 0 01 00 00 0 0 03 00 00 0 0 01 00 00 0 0 01 00 00 0 0 01 00 00 0 0 01 00 00 0 0 01 00 00 0 0 01 00 00 0 0 01 00 00 0 0 01 00 00 0 0 16 07 00 0 0 16 00 00 1 0
16 00 00 1 1 16 08 00 0 0 01 00 00 0 0 01 00 00 0 0 02 00 00 0 0 01 00 00 0 0 01 00 00 0 0 01 00 00 0 0 02 00 00 0 0 01 00 00 0 0 02 00 00 0 0 01 00 00 0 0 01 00 00 0 0 02 00 00 0 0 01 00 00 0 0 01 00 00 0 0 01 00 00 0 0 01 00 00 0 0 01 00 00 0 0 02 00 00 0 0 16 07 00 0 0 16 00 00 1 0
16 00 00 1 0 16 08 00 0 0 02 00 00 0 0 02 00 00 0 0 03 00 00 0 0 02 00 00 0 0 01 00 00 0 0 01 00 00 0 0 01 00 00 0 0 03 00 00 0 0 01 00 00 0 0 02 00 00 0 0 01 00 00 0 0 02 00 00 0 0 02 00 00 0 0 01 00 00 0 0 03 00 00 0 0 01 00 00 0 0 02 00 00 0 0 01 00 00 0 0 16 07 00 0 0 16 00 00 1 0
16 00 00 1 0 16 08 00 0 0 01 00 00 0 0 01 00 00 0 0 01 00 00 0 0 01 00 00 0 0 01 00 00 0 0 01 00 00 0 0 01 00 00 0 0 01 00 00 0 0 01 00 00 0 0 01 00 00 0 0 01 00 00 0 0 01 00 00 0 0 01 00 00 0 0 01 00 00 0 0 01 00 00 0 0 01 00 00 0 0 01 00 00 0 0 01 00 00 0 0 16 07 00 0 0 16 00 00 1 0
16 00 00 1 0 16 08 00 0 0 03 00 00 0 0 01 00 00 0 0 01 00 00 0 0 01 00 00 0 0 01 00 00 0 0 01 00 00 0 0 01 00 00 0 0 01 00 00 0 0 02 00 00 0 0 01 00 00 0 0 01 00 00 0 0 01 00 00 0 0 01 00 00 0 0 01 00 00 0 0 02 00 00 0 0 02 00 00 0 0 01 00 00 0 0 01 00 00 0 0 16 07 00 0 0 16 00 00 1 0
16 00 00 1 0 16 08 00 0 0 02 00 00 0 0 01 00 00 0 0 01 00 00 0 0 01 00 00 0 0 02 00 00 0 0 01 00 00 0 0 01 00 00 0 0 02 00 00 0 0 01 00 00 0 0 01 00 00 0 0 01 00 00 0 0 01 00 00 0 0 01 00 00 0 0 02 00 00 0 0 01 00 00 0 0 02 00 00 0 0 01 00 00 0 0 01 00 00 0 0 16 07 00 0 0 16 00 00 1 0
16 00 00 1 0 16 08 00 0 0 01 00 00 0 0 02 00 00 0 0 01 00 00 0 0 01 00 00 0 0 03 00 00 0 0 02 00 00 0 0 02 00 00 0 0 01 00 00 0 0 01 00 00 0 0 01 00 00 0 0 01 00 00 0 0 01 00 00 0 0 01 00 00 0 0 01 00 00 0 0 01 00 00 0 0 01 00 00 0 0 02 00 00 0 0 01 00 00 0 0 16 07 00 0 0 16 00 00 1 0
16 00 00 1 0 16 08 00 0 0 01 00 00 0 0 01 00 00 0 0 02 00 00 0 0 01 00 00 0 0 02 00 00 0 0 01 00 00 0 0 01 00 00 0 0 01 00 00 0 0 01 00 00 0 0 02 00 00 0 0 03 00 00 0 0 01 00 00 0 0 01 00 00 0 0 01 00 00 0 0 02 00 00 0 0 01 00 00 0 0 01 00 00 0 0 01 00 00 0 0 16 07 00 0 0 16 00 00 1 0
16 00 00 1 0 16 14 00 0 0 16 05 00 0 0 16 05 00 0 0 16 06 00 0 0 01 00 00 0 0 01 00 00 0 0 01 00 00 0 0 01 00 00 0 0 02 00 00 0 0 01 00 00 0 0 01 00 00 0 0 03 00 00 0 0 03 00 00 0 0 01 00 00 0 0 01 00 00 0 0 01 00 00 0 0 02 00 00 0 0 01 00 00 0 0 01 00 00 0 0 16 07 00 0 0 16 00 00 1 0
16 00 00 1 0 16 12 00 0 0 16 10 00 0 0 16 10 00 0 0 16 11 00 0 0 01 00 00 0 0 01 00 00 0 0 01 00 00 0 0 01 00 00 0 0 01 00 00 0 0 01 00 00 0 0 01 00 00 0 0 03 00 00 0 0 02 00 00 0 0 01 00 00 0 0 01 00 00 0 0 01 00 00 0 0 02 00 00 0 0 01 00 00 0 0 02 00 00 0 0 16 07 00 0 0 16 00 00 1 0
16 00 00 1 0 16 08 00 0 0 03 00 00 0 0 03 00 00 0 0 01 00 00 0 0 01 00 00 0 0 01 00 00 0 0 01 00 00 0 0 01 00 00 0 0 01 00 00 0 0 01 00 00 0 0 01 00 00 0 0 01 00 00 0 0 01 00 00 0 0 03 00 00 0 0 03 00 00 0 0 01 00 00 0 0 03 00 00 0 0 01 00 00 0 0 01 00 00 0 0 16 07 00 0 0 16 00 00 1 0
16 00 00 1 0 16 08 00 0 0 03 00 00 0 0 02 00 00 0 0 01 00 00 0 0 01 00 00 0 0 01 00 00 0 0 02 00 00 0 0 01 00 00 0 0 01 00 00 0 0 01 00 00 0 0 01 00 00 0 0 01 00 00 0 0 01 00 00 0 0 01 00 00 0 0 03 00 00 0 0 01 00 00 0 0 01 00 00 0 0 01 00 00 0 0 02 00 00 0 0 16 07 00 0 0 16 00 00 1 0
16 00 00 1 0 16 08 00 0 0 02 00 00 0 0 01 00 00 0 0 01 00 00 0 0 01 00 00 0 0 03 00 00 0 0 02 00 00 0 0 01 00 00 0 0 01 00 00 0 0 01 00 00 0 0 01 00 00 0 0 01 00 00 0 0 01 00 00 0 0 03 00 00 0 0 01 00 00 0 0 01 00 00 0 0 01 00 00 0 0 03 00 00 0 0 01 00 00 0 0 16 07 00 0 0 16 00 00 1 0
16 00 00 1 0 16 08 00 0 0 01 00 00 0 0 01 00 00 0 0 01 00 00 0 0 01 00 00 0 0 03 00 00 0 0 02 00 00 0 0 01 00 00 0 0 01 00 00 0 0 01 00 00 0 0 01 00 00 0 0 01 00 00 0 0 01 00 00 0 0 01 00 00 0 0 01 00 00 0 0 01 00 00 0 0 01 00 00 0 0 03 00 00 0 0 02 00 00 0 0 16 07 00 0 0 16 00 00 1 0
16 00 00 1 0 16 08 00 0 0 01 00 00 0 0 02 00 00 0 0 03 00 00 0 0 03 00 00 0 0 02 00 00 0 0 01 00 00 0 0 01 00 00 0 0 01 00 00 0 0 01 00 00 0 0 01 00 00 0 0 01 00 00 0 0 01 00 00 0 0 02 00 00 0 0 02 00 00 0 0 01 00 00 0 0 03 00 00 0 0 02 00 00 0 0 01 00 00 0 0 16 07 00 0 0 16 00 00 1 0
16 00 00 1 0 16 08 00 0 0 01 00 00 0 0 01 00 00 0 0 01 00 00 0 0 03 00 00 0 0 01 00 00 0 0 01 00 00 0 0 01 00 00 0 0 03 00 00 0 0 02 00 00 0 0 01 00 00 0 0 01 00 00 0 0 01 00 00 0 0 01 00 00 0 0 02 00 00 0 0 01 00 00 0 0 02 00 00 0 0 01 00 00 0 0 01 00 00 0 0 16 07 00 0 0 16 00 00 1 0
16 00 00 1 0 16 08 00 0 0 01 00 00 0 0 01 00 00 0 0 02 00 00 0 0 01 00 00 0 0 01 00 00 0 0 01 00 00 0 0 03 00 00 0 0 01 00 00 0 0 02 00 00 0 0 01 00 00 0 0 01 00 00 0 0 01 00 00 0 0 01 00 00 0 0 01 00 00 0 0 01 00 00 0 0 01 00 00 0 0 01 00 00 0 0 01 00 00 0 0 16 07 00 0 0 16 00 00 1 0
16 00 00 1 0 16 08 00 0 0 02 00 00 0 0 01 00 00 0 0 01 00 00 0 0 01 00 00 0 0 01 00 00 0 0 01 00 00 0 0 01 00 00 0 0 01 00 00 0 0 01 00 00 0 0 03 00 00 0 0 01 00 00 0 0 01 00 00 0 0 02 00 00 0 0 01 00 00 0 0 01 00 00 0 0 01 00 00 0 0 02 00 00 0 0 01 00 00 0 0 16 07 00 0 0 16 00 00 1 0
16 00 00 1 0 16 14 00 0 0 16 05 00 0 0 16 05 00 0 0 16 05 00 0 0 16 05 00 0 0 16 05 00 0 0 16 05 00 0 0 16 05 00 0 0 16 05 00 0 0 16 05 00 0 0 16 05 00 0 0 16 05 00 0 0 16 05 00 0 0 16 05 00 0 0 16 05 00 0 0 16 05 00 0 0 16 05 00 0 0 16 05 00 0 0 16 05 00 0 0 16 15 00 0 0 16 00 00 1 0
16 00 00 1 0 16 00 00 1 0 16 00 00 1 0 16 00 00 1 0 16 00 00 1 0 16 00 00 1 0 16 00 00 1 0 16 00 00 1 0 16 00 00 1 0 16 00 00 1 0 16 00 00 1 0 16 00 00 1 0 16 00 00 1 0 16 00 00 1 0 16 00 00 1 0 16 00 00 1 0 16 00 00 1 0 16 00 00 1 0 16 00 00 1 0 16 00 00 1 0 16 00 00 1 0 16 00 00 1 0

