25 25
01 00 00 0 0 01 00 00 0 0 01 00 00 0 0 01 00 00 0 0 01 00 00 0 0 01 00 00 0 0 01 00 00 0 0 01 00 00 0 0 01 00 00 0 0 01 00 00 0 0 01 00 00 0 0 01 00 00 0 0 01 00 00 0 0 01 00 00 0 0 01 00 00 0 0 01 00 00 0 0 01 00 00 0 0 01 00 00 0 0 01 00 00 0 0 01 00 00 0 0 01 00 00 0 0 01 00 00 0 0 01 00 00 0 0 01 00 00 0 0 01 00 00 0 0 
01 00 00 0 0 01 00 00 0 0 01 00 00 0 0 01 00 00 0 0 01 00 00 0 0 01 00 00 0 0 01 00 00 0 0 01 00 00 0 0 01 00 00 0 0 01 00 00 0 0 01 00 00 0 0 01 00 00 0 0 01 00 00 0 0 01 00 00 0 0 01 00 00 0 0 01 00 00 0 0 01 00 00 0 0 01 00 00 0 0 01 00 00 0 0 01 00 00 0 0 01 00 00 0 0 01 00 00 0 0 01 00 00 0 0 01 00 00 0 0 01 00 00 0 0 
01 00 00 0 0 01 00 00 0 0 01 00 00 0 0 01 00 00 0 0 01 00 00 0 0 01 00 00 0 0 01 00 00 0 0 03 00 00 0 0 01 00 00 0 0 01 00 00 0 0 01 00 00 0 0 01 00 00 0 0 01 00 00 0 0 01 00 00 0 0 01 00 00 0 0 01 00 00 0 0 01 00 00 0 0 02 00 00 0 0 01 00 00 0 0 01 00 00 0 0 01 00 00 0 0 01 00 00 0 0 01 00 00 0 0 01 00 00 0 0 03 00 00 0 0 
01 00 00 0 0 01 00 00 0 0 01 00 00 0 0 01 00 00 0 0 01 00 00 0 0 01 00 00 0 0 01 00 00 0 0 01 00 00 0 0 01 00 00 0 0 01 00 00 0 0 01 00 00 0 0 01 00 00 0 0 01 00 00 0 0 01 00 00 0 0 01 00 00 0 0 01 00 00 0 0 01 00 00 0 0 01 00 00 0 0 01 00 00 0 0 01 00 00 0 0 01 00 00 0 0 01 00 00 0 0 01 00 00 0 0 01 00 00 0 0 01 00 00 0 0 
01 00 00 0 0 01 00 00 0 0 01 00 00 0 0 01 00 00 0 0 01 00 00 0 0 02 00 00 0 0 01 00 00 0 0 01 00 00 0 0 01 00 00 0 0 01 00 00 0 0 01 00 00 0 0 01 00 00 0 0 01 00 00 0 0 01 00 00 0 0 01 00 00 0 0 01 00 00 0 0 01 00 00 0 0 01 00 00 0 0 01 00 00 0 0 01 00 00 0 0 01 00 00 0 0 01 00 00 0 0 01 00 00 0 0 01 00 00 0 0 01 00 00 0 0 
01 00 00 0 0 01 00 00 0 0 01 00 00 0 0 01 00 00 0 0 03 00 00 0 0 01 00 00 0 0 01 00 00 0 0 02 00 00 0 0 01 00 00 0 0 01 00 00 0 0 01 00 00 0 0 01 00 00 0 0 01 00 00 0 0 01 00 00 0 0 01 00 00 0 0 01 00 00 0 0 01 00 00 0 0 01 00 00 0 0 01 00 00 0 0 01 00 00 0 0 01 00 00 0 0 01 00 00 0 0 01 00 00 0 0 01 00 00 0 0 01 00 00 0 0 
01 00 00 0 0 01 00 00 0 0 01 00 00 0 0 01 00 00 0 0 01 00 00 0 0 01 00 00 0 0 01 00 00 0 0 01 00 00 0 0 01 00 00 0 0 01 00 00 0 0 01 00 00 0 0 01 00 00 0 0 01 00 00 0 0 01 00 00 0 0 01 00 00 0 0 01 00 00 0 0 01 00 00 0 0 01 00 00 0 0 01 00 00 0 0 01 00 00 0 0 01 00 00 0 0 01 00 00 0 0 01 00 00 0 0 01 00 00 0 0 01 00 00 0 0 
01 00 00 0 0 01 00 00 0 0 01 00 00 0 0 01 00 00 0 0 01 00 00 0 0 01 00 00 0 0 01 00 00 0 0 01 00 00 0 0 01 00 00 0 0 01 00 00 0 0 01 00 00 0 0 01 00 00 0 0 01 00 00 0 0 01 00 00 0 0 01 00 00 0 0 01 00 00 0 0 01 00 00 0 0 01 00 00 0 0 01 00 00 0 0 01 00 00 0 0 02 00 00 0 0 01 00 00 0 0 01 00 00 0 0 01 00 00 0 0 01 00 00 0 0 
01 00 00 0 0 01 00 00 0 0 01 00 00 0 0 01 00 00 0 0 01 00 00 0 0 01 00 00 0 0 01 00 00 0 0 01 00 00 0 0 01 00 00 0 0 01 00 00 0 0 01 00 00 0 0 01 00 00 0 0 01 00 00 0 0 01 00 00 0 0 01 00 00 0 0 01 00 00 0 0 01 00 00 0 0 01 00 00 0 0 01 00 00 0 0 01 00 00 0 0 01 00 00 0 0 01 00 00 0 0 01 00 00 0 0 01 00 00 0 0 01 00 00 0 0 
01 00 00 0 0 01 00 00 0 0 02 00 00 0 0 02 00 00 0 0 01 00 00 0 0 01 00 00 0 0 01 00 00 0 0 01 00 00 0 0 01 00 00 0 0 01 00 00 0 0 01 00 00 0 0 01 00 00 0 0 01 00 00 0 0 01 00 00 0 0 01 00 00 0 0 01 00 00 0 0 01 00 00 0 0 02 00 00 0 0 01 00 00 0 0 01 00 00 0 0 01 00 00 0 0 01 00 00 0 0 03 00 00 0 0 02 00 00 0 0 01 00 00 0 0 
01 00 00 0 0 01 00 00 0 0 01 00 00 0 0 01 00 00 0 0 01 00 00 0 0 01 00 00 0 0 01 00 00 0 0 01 00 00 0 0 01 00 00 0 0 01 00 00 0 0 02 00 00 0 0 01 00 00 0 0 01 00 00 0 0 01 00 00 0 0 01 00 00 0 0 01 00 00 0 0 01 00 00 0 0 01 00 00 0 0 01 00 00 0 0 01 00 00 0 0 01 00 00 0 0 01 00 00 0 0 01 00 00 0 0 01 00 00 0 0 01 00 00 0 0 
01 00 00 0 0 01 00 00 0 0 01 00 00 0 0 01 00 00 0 0 01 00 00 0 0 01 00 00 0 0 01 00 00 0 0 02 00 00 0 0 01 00 00 0 0 01 00 00 0 0 01 00 00 0 0 01 00 00 0 0 01 00 00 0 0 01 00 00 0 0 01 00 00 0 0 01 00 00 0 0 01 00 00 0 0 01 00 00 0 0 01 00 00 0 0 01 00 00 0 0 01 00 00 0 0 01 00 00 0 0 01 00 00 0 0 01 00 00 0 0 01 00 00 0 0 
01 00 00 0 0 01 00 00 0 0 01 00 00 0 0 01 00 00 0 0 01 00 00 0 0 01 00 00 0 0 01 00 00 0 0 01 00 00 0 0 01 00 00 0 0 01 00 00 0 0 01 00 00 0 0 01 00 00 0 0 01 00 00 0 0 01 00 00 0 0 01 00 00 0 0 01 00 00 0 0 01 00 00 0 0 01 00 00 0 0 01 00 00 0 0 01 00 00 0 0 01 00 00 0 0 01 00 00 0 0 01 00 00 0 0 01 00 00 0 0 01 00 00 0 0 
01 00 00 0 0 01 00 00 0 0 01 00 00 0 0 01 00 00 0 0 01 00 00 0 0 03 00 00 0 0 01 00 00 0 0 02 00 00 0 0 02 00 00 0 0 01 00 00 0 0 01 00 00 0 0 01 00 00 0 0 01 00 00 0 0 01 00 00 0 0 01 00 00 0 0 01 00 00 0 0 01 00 00 0 0 01 00 00 0 0 01 00 00 0 0 01 00 00 0 0 01 00 00 0 0 01 00 00 0 0 01 00 00 0 0 02 00 00 0 0 01 00 00 0 0 
01 00 00 0 0 01 00 00 0 0 02 00 00 0 0 01 00 00 0 0 01 00 00 0 0 02 00 00 0 0 03 00 00 0 0 03 00 00 0 0 01 00 00 0 0 01 00 00 0 0 01 00 00 0 0 01 00 00 0 0 01 00 00 0 0 01 00 00 0 0 01 00 00 0 0 01 00 00 0 0 01 00 00 0 0 01 00 00 0 0 01 00 00 0 0 01 00 00 0 0 01 00 00 0 0 01 00 00 0 0 01 00 00 0 0 01 00 00 0 0 01 00 00 0 0 
01 00 00 0 0 01 00 00 0 0 01 00 00 0 0 01 00 00 0 0 01 00 00 0 0 02 00 00 0 0 01 00 00 0 0 02 00 00 0 0 01 00 00 0 0 01 00 00 0 0 01 00 00 0 0 01 00 00 0 0 01 00 00 0 0 01 00 00 0 0 01 00 00 0 0 01 00 00 0 0 01 00 00 0 0 01 00 00 0 0 01 00 00 0 0 01 00 00 0 0 01 00 00 0 0 01 00 00 0 0 01 00 00 0 0 01 00 00 0 0 01 00 00 0 0 
01 00 00 0 0 01 00 00 0 0 01 00 00 0 0 01 00 00 0 0 01 00 00 0 0 01 00 00 0 0 01 00 00 0 0 02 00 00 0 0 01 00 00 0 0 01 00 00 0 0 01 00 00 0 0 01 00 00 0 0 01 00 00 0 0 01 00 00 0 0 01 00 00 0 0 01 00 00 0 0 01 00 00 0 0 01 00 00 0 0 01 00 00 0 0 01 00 00 0 0 01 00 00 0 0 01 00 00 0 0 01 00 00 0 0 01 00 00 0 0 01 00 00 0 0 
01 00 00 0 0 01 00 00 0 0 01 00 00 0 0 01 00 00 0 0 01 00 00 0 0 01 00 00 0 0 02 00 00 0 0 01 00 00 0 0 01 00 00 0 0 01 00 00 0 0 01 00 00 0 0 01 00 00 0 0 01 00 00 0 0 01 00 00 0 0 01 00 00 0 0 01 00 00 0 0 01 00 00 0 0 01 00 00 0 0 01 00 00 0 0 01 00 00 0 0 01 00 00 0 0 01 00 00 0 0 01 00 00 0 0 01 00 00 0 0 01 00 00 0 0 
01 00 00 0 0 01 00 00 0 0 01 00 00 0 0 01 00 00 0 0 01 00 00 0 0 02 00 00 0 0 02 00 00 0 0 01 00 00 0 0 01 00 00 0 0 01 00 00 0 0 01 00 00 0 0 01 00 00 0 0 01 00 00 0 0 01 00 00 0 0 01 00 00 0 0 01 00 00 0 0 01 00 00 0 0 01 00 00 0 0 01 00 00 0 0 01 00 00 0 0 01 00 00 0 0 01 00 00 0 0 02 00 00 0 0 01 00 00 0 0 01 00 00 0 0 
01 00 00 0 0 01 00 00 0 0 01 00 00 0 0 01 00 00 0 0 01 00 00 0 0 01 00 00 0 0 01 00 00 0 0 01 00 00 0 0 01 00 00 0 0 01 00 00 0 0 01 00 00 0 0 01 00 00 0 0 01 00 00 0 0 01 00 00 0 0 01 00 00 0 0 01 00 00 0 0 01 00 00 0 0 01 00 00 0 0 01 00 00 0 0 01 00 00 0 0 01 00 00 0 0 01 00 00 0 0 01 00 00 0 0 01 00 00 0 0 01 00 00 0 0 
01 00 00 0 0 01 00 00 0 0 01 00 00 0 0 01 00 00 0 0 01 00 00 0 0 01 00 00 0 0 01 00 00 0 0 01 00 00 0 0 01 00 00 0 0 01 00 00 0 0 01 00 00 0 0 01 00 00 0 0 01 00 00 0 0 02 00 00 0 0 01 00 00 0 0 01 00 00 0 0 01 00 00 0 0 01 00 00 0 0 01 00 00 0 0 01 00 00 0 0 01 00 00 0 0 01 00 00 0 0 01 00 00 0 0 01 00 00 0 0 01 00 00 0 0 
01 00 00 0 0 01 00 00 0 0 01 00 00 0 0 01 00 00 0 0 01 00 00 0 0 01 00 00 0 0 01 00 00 0 0 01 00 00 0 0 01 00 00 0 0 01 00 00 0 0 01 00 00 0 0 01 00 00 0 0 01 00 00 0 0 01 00 00 0 0 01 00 00 0 0 01 00 00 0 0 01 00 00 0 0 01 00 00 0 0 01 00 00 0 0 01 00 00 0 0 01 00 00 0 0 01 00 00 0 0 01 00 00 0 0 01 00 00 0 0 02 00 00 0 0 
01 00 00 0 0 01 00 00 0 0 01 00 00 0 0 01 00 00 0 0 01 00 00 0 0 01 00 00 0 0 01 00 00 0 0 01 00 00 0 0 01 00 00 0 0 01 00 00 0 0 01 00 00 0 0 01 00 00 0 0 01 00 00 0 0 01 00 00 0 0 01 00 00 0 0 01 00 00 0 0 01 00 00 0 0 01 00 00 0 0 01 00 00 0 0 01 00 00 0 0 01 00 00 0 0 01 00 00 0 0 01 00 00 0 0 01 00 00 0 0 01 00 00 0 0 
01 00 00 0 0 01 00 00 0 0 01 00 00 0 0 01 00 00 0 0 01 00 00 0 0 01 00 00 0 0 01 00 00 0 0 01 00 00 0 0 01 00 00 0 0 03 00 00 0 0 01 00 00 0 0 01 00 00 0 0 01 00 00 0 0 01 00 00 0 0 01 00 00 0 0 01 00 00 0 0 01 00 00 0 0 01 00 00 0 0 01 00 00 0 0 01 00 00 0 0 01 00 00 0 0 01 00 00 0 0 01 00 00 0 0 01 00 00 0 0 01 00 00 0 0 
01 00 00 0 0 01 00 00 0 0 01 00 00 0 0 01 00 00 0 0 01 00 00 0 0 01 00 00 0 0 01 00 00 0 0 01 00 00 0 0 01 00 00 0 0 01 00 00 0 0 01 00 00 0 0 01 00 00 0 0 01 00 00 0 0 01 00 00 0 0 01 00 00 0 0 01 00 00 0 0 01 00 00 0 0 01 00 00 0 0 01 00 00 0 0 01 00 00 0 0 01 00 00 0 0 01 00 00 0 0 01 00 00 0 0 01 00 00 0 0 03 00 00 0 0 
