41 30
65 0 0 0 0 66 0 0 0 0 65 0 0 0 0 66 112 0 0 0 64 112 0 0 0 65 113 0 0 0 97 0 0 1 0 46 109 0 0 0 48 0 0 0 0 46 0 0 0 0 46 0 0 0 0 48 0 0 0 0 46 0 0 0 0 48 0 0 0 0 46 0 0 0 0 46 0 0 0 0 46 0 0 0 0 46 112 0 0 0 46 113 0 0 0 97 0 0 1 0 97 0 0 1 0 97 0 0 1 0 17 106 0 0 0 16 115 0 1 0 17 115 0 1 0 16 8 0 0 0 2 110 0 0 0 83 0 0 1 1 83 0 0 1 1 83 0 0 1 1 83 0 0 1 1 2 109 100 1 0 1 100 0 1 0 2 100 0 1 0 2 100 0 1 0 2 100 0 1 0 1 100 0 1 0 2 100 0 1 0 2 100 0 1 0 1 100 0 1 0 2 100 0 1 0 
65 0 0 0 0 64 0 0 0 0 64 113 0 0 0 97 0 0 1 0 97 0 0 1 0 97 0 0 1 0 97 0 0 1 0 46 109 0 0 0 46 0 0 0 0 46 0 0 0 0 47 160 0 0 0 46 0 0 0 0 46 0 0 0 0 46 112 0 0 0 46 112 0 0 0 46 112 0 0 0 46 113 0 0 0 97 0 0 1 0 97 0 0 1 0 97 0 0 1 0 97 0 0 1 0 16 106 0 0 0 17 0 0 0 0 16 0 0 0 0 16 12 0 0 0 16 11 0 0 0 1 110 0 0 0 83 0 0 1 1 83 0 0 1 1 83 0 0 1 1 83 0 0 1 1 1 109 0 0 0 1 0 0 0 0 1 100 0 1 0 3 0 0 0 0 1 0 0 0 0 1 100 0 1 0 1 0 0 0 0 1 100 0 1 0 1 100 0 1 0 1 100 0 1 0 
66 112 0 0 0 65 113 0 0 0 97 0 0 1 0 97 0 0 1 0 97 0 0 1 0 97 0 0 1 0 46 106 0 0 0 46 0 0 0 0 46 161 0 0 0 46 0 0 0 0 46 0 0 0 0 46 112 0 0 0 46 113 0 0 0 97 0 0 1 0 97 0 0 1 0 97 0 0 1 0 97 0 0 1 0 97 0 0 1 0 97 0 0 1 0 16 106 0 0 0 16 107 0 0 0 16 0 0 0 0 16 0 0 0 0 17 0 0 0 0 16 8 0 0 0 2 0 0 0 0 1 110 0 0 0 83 0 0 1 1 83 0 0 1 1 83 0 0 1 1 83 0 0 1 1 1 111 0 0 0 2 0 0 0 0 2 0 0 0 0 1 100 0 1 0 1 0 0 0 0 2 0 0 0 0 1 0 0 0 0 2 0 0 0 0 1 0 0 0 0 2 100 0 1 0 
97 0 0 1 0 97 0 0 1 0 97 0 0 1 0 46 106 0 0 0 46 107 0 0 0 46 107 0 0 0 48 0 0 0 0 46 0 0 0 0 47 0 0 0 0 46 112 0 0 0 46 113 0 0 0 97 0 0 1 0 97 0 0 1 0 97 0 0 1 0 97 0 0 1 0 97 0 0 1 0 97 0 0 1 0 16 106 0 0 0 16 107 0 0 0 16 0 0 0 0 17 0 0 0 0 18 0 0 0 0 16 0 0 0 0 16 12 0 0 0 16 11 0 0 0 1 0 0 0 0 1 110 0 0 0 83 0 0 1 1 83 0 0 1 1 83 0 0 1 1 83 0 0 1 1 83 0 0 1 1 2 109 0 0 0 1 0 0 0 0 1 0 0 0 0 1 0 0 0 0 3 0 0 0 0 2 0 0 0 0 1 0 0 0 0 1 0 0 0 0 1 100 0 1 0 
97 0 0 1 0 97 0 0 1 0 46 106 0 0 0 48 0 0 0 0 46 0 0 0 0 46 160 0 0 0 46 0 0 0 0 46 0 0 0 0 46 113 0 0 0 97 0 0 1 0 97 0 0 1 0 97 0 0 1 0 97 0 0 1 0 31 106 0 0 0 16 39 0 0 0 16 43 0 0 0 16 107 0 0 0 16 0 0 0 0 17 0 0 0 0 16 0 0 0 0 16 0 0 0 0 17 0 0 0 0 17 0 0 0 0 16 8 0 0 0 1 0 0 0 0 1 110 0 0 0 127 0 0 0 0 127 0 0 0 0 127 0 0 0 0 127 0 0 0 0 127 0 0 0 0 127 0 0 0 0 127 0 0 0 0 1 109 0 0 0 2 0 0 0 0 2 0 0 0 0 1 0 0 0 0 1 0 0 0 0 1 0 0 0 0 1 100 0 1 0 2 100 0 1 0 
46 107 0 0 0 46 107 0 0 0 46 0 0 0 0 46 0 0 0 0 46 0 0 0 0 47 0 0 0 0 46 0 0 0 0 46 113 0 0 0 97 0 0 1 0 97 0 0 1 0 97 0 0 1 0 31 106 0 0 0 31 107 0 0 0 31 0 0 0 0 16 34 0 0 0 16 45 0 0 0 16 0 0 0 0 17 0 0 0 0 16 0 0 0 0 16 0 0 0 0 17 0 0 0 0 16 0 0 0 0 16 0 0 0 0 16 8 0 0 0 1 0 0 0 0 2 0 0 0 0 1 110 0 0 0 83 0 0 1 1 83 0 0 1 1 83 0 0 1 1 83 0 0 1 1 83 0 0 1 1 1 111 0 0 0 2 0 0 0 0 1 0 0 0 0 1 0 0 0 0 1 100 0 1 0 1 0 0 0 0 2 0 0 0 0 1 0 0 0 0 2 100 0 1 0 
46 0 0 0 0 46 0 0 0 0 46 0 0 0 0 46 0 0 0 0 46 161 0 0 0 46 112 0 0 0 46 113 0 0 0 97 0 0 1 0 97 0 0 1 0 31 106 0 0 0 31 107 0 0 0 31 32 0 0 0 31 0 0 0 0 31 32 0 0 0 16 39 0 0 0 17 43 0 0 0 18 0 0 0 0 16 0 0 0 0 16 0 0 0 0 16 0 0 0 0 17 0 0 0 0 16 0 0 0 0 16 12 0 0 0 16 11 0 0 0 1 0 0 0 0 1 0 0 0 0 1 0 0 0 0 1 108 0 0 0 83 0 0 1 1 83 0 0 1 1 83 0 0 1 1 83 0 0 1 1 83 0 0 1 1 1 109 0 0 0 2 0 0 0 0 1 0 0 0 0 2 0 0 0 0 1 0 0 0 0 1 0 0 0 0 1 100 0 1 0 2 100 0 1 0 
46 112 0 0 0 48 112 0 0 0 46 112 0 0 0 48 112 0 0 0 46 113 0 0 0 97 0 0 1 0 97 0 0 1 0 97 0 0 1 0 31 106 0 0 0 31 32 0 0 0 31 60 0 0 0 31 58 0 0 0 31 58 0 0 0 31 58 0 0 0 31 61 0 0 0 16 37 0 0 0 16 0 0 0 0 16 0 0 0 0 17 0 0 0 0 16 0 0 0 0 16 0 0 0 0 18 12 0 0 0 16 11 0 0 0 3 0 0 0 0 1 0 0 0 0 2 0 0 0 0 1 0 0 0 0 1 110 0 0 0 83 0 0 1 1 83 0 0 1 1 83 0 0 1 1 83 0 0 0 0 83 0 0 1 1 1 109 0 0 0 1 100 0 1 0 1 0 0 0 0 2 0 0 0 0 1 0 0 0 0 2 0 0 0 0 2 0 0 0 0 1 100 0 1 0 
97 0 0 1 0 97 0 0 1 0 97 0 0 1 0 97 0 0 1 0 97 0 0 1 0 97 0 0 1 0 97 0 0 1 0 31 106 0 0 0 31 60 0 0 0 31 58 0 0 0 31 59 0 0 0 49 0 0 0 0 49 51 0 0 0 49 0 0 0 0 31 55 0 0 0 16 39 0 0 0 16 43 0 0 0 16 0 0 0 0 16 0 0 0 0 16 0 0 0 0 16 12 0 0 0 16 11 0 0 0 1 0 0 0 0 1 0 0 0 0 1 0 0 0 0 1 0 0 0 0 1 0 0 0 0 1 110 0 0 0 83 0 0 1 1 83 0 0 1 1 83 0 0 1 1 83 0 0 1 1 83 0 0 1 1 2 109 0 0 0 1 0 0 0 0 3 0 0 0 0 2 0 0 0 0 1 0 0 0 0 2 0 0 0 0 1 0 0 0 0 2 100 0 1 0 
97 0 0 1 0 97 0 0 1 0 97 162 0 0 0 97 0 0 1 0 97 0 0 1 0 31 106 0 0 0 31 107 0 0 0 31 60 0 0 0 31 59 0 0 0 49 0 0 0 0 49 79 0 0 0 49 50 0 0 0 49 0 0 0 0 49 0 0 0 0 31 55 0 0 0 31 0 0 0 0 16 39 0 0 0 16 43 0 0 0 17 0 0 0 0 16 0 0 0 0 16 8 0 0 0 1 0 0 0 0 1 174 0 1 0 2 0 0 0 0 1 0 0 0 0 1 0 0 0 0 2 0 0 0 0 1 110 0 0 0 83 0 0 1 1 83 0 0 1 1 83 0 0 1 1 83 0 0 0 0 83 0 0 1 1 1 109 0 0 0 2 0 0 0 0 2 100 0 1 0 2 0 0 0 0 1 100 0 1 0 1 0 0 0 0 1 0 0 0 0 1 100 0 1 0 
31 107 0 0 0 31 107 0 0 0 31 107 0 0 0 31 107 0 0 0 31 107 0 0 0 31 32 0 0 0 31 60 0 0 0 31 59 0 0 0 49 0 0 0 0 49 50 0 0 0 49 50 0 0 0 49 51 0 0 0 49 0 0 0 0 49 50 0 0 0 31 55 0 0 0 31 0 0 0 0 31 0 0 0 0 16 37 0 0 0 16 0 0 0 0 18 0 0 0 0 16 8 0 0 0 2 0 0 0 0 1 0 0 0 0 1 0 0 0 0 1 0 0 0 0 3 0 0 0 0 1 0 0 0 0 1 0 0 0 0 1 108 0 0 0 83 0 0 1 1 83 0 0 1 1 83 0 0 1 1 83 0 0 1 1 1 111 0 0 0 1 0 0 0 0 1 0 0 0 0 1 0 0 0 0 1 0 0 0 0 2 0 0 0 0 1 100 0 1 0 2 100 0 1 0 
31 32 0 0 0 31 161 0 0 0 31 0 0 0 0 31 0 0 0 0 31 32 0 0 0 31 32 0 0 0 31 56 0 0 0 49 51 0 0 0 49 79 0 0 0 49 0 0 0 0 49 0 0 0 0 49 50 0 0 0 49 79 0 0 0 49 0 0 0 0 31 55 0 0 0 31 32 0 0 0 31 0 0 0 0 16 39 0 0 0 16 43 0 0 0 16 0 0 0 0 16 14 0 0 0 16 6 0 0 0 1 0 0 0 0 1 100 0 1 0 1 0 0 0 0 2 0 0 0 0 1 0 0 0 0 1 0 0 0 0 1 110 0 0 0 83 0 0 1 1 83 0 0 1 1 83 0 0 1 1 83 0 0 1 1 83 0 0 1 1 1 111 0 0 0 1 112 0 0 0 2 0 0 0 0 1 0 0 0 0 2 0 0 0 0 1 0 0 0 0 1 100 0 1 0 
31 32 0 0 0 31 32 0 0 0 31 0 0 0 0 31 0 0 0 0 31 32 0 0 0 31 0 0 0 0 31 56 0 0 0 49 0 0 0 0 49 50 0 0 0 49 0 0 0 0 49 51 0 0 0 49 0 0 0 0 49 50 0 0 0 31 52 0 0 0 31 63 0 0 0 31 174 0 1 0 31 0 0 0 0 31 0 0 0 0 17 37 0 0 0 16 0 0 0 0 17 0 0 0 0 16 8 0 0 0 1 0 0 0 0 2 0 0 0 0 1 0 0 0 0 2 0 0 0 0 1 0 0 0 0 3 0 0 0 0 2 110 0 0 0 83 0 0 1 1 83 0 0 1 1 83 0 0 1 1 83 0 0 1 1 83 0 0 1 1 83 0 0 1 1 83 0 0 1 1 1 111 0 0 0 2 0 0 0 0 1 0 0 0 0 2 0 0 0 0 2 100 0 1 0 
31 0 0 0 0 31 0 0 0 0 31 32 0 0 0 31 0 0 0 0 31 32 0 0 0 31 32 0 0 0 31 62 0 0 0 31 54 0 0 0 49 0 0 0 0 49 50 0 0 0 49 0 0 0 0 49 0 0 0 0 31 52 0 0 0 31 63 0 0 0 31 0 0 0 0 31 0 0 0 0 31 32 0 0 0 31 0 0 0 0 16 37 0 0 0 16 0 0 0 0 16 0 0 0 0 16 14 0 0 0 17 6 0 0 0 1 0 0 0 0 1 0 0 0 0 1 0 0 0 0 1 0 0 0 0 1 0 0 0 0 1 110 0 0 0 83 0 0 1 1 83 0 0 1 1 83 0 0 1 1 83 0 0 1 1 83 0 0 1 1 83 0 0 1 1 83 0 0 1 1 83 0 0 1 1 1 111 0 0 0 2 112 0 0 0 1 112 0 0 0 1 100 0 1 0 
17 35 0 0 0 16 35 0 0 0 16 36 0 0 0 31 0 0 0 0 31 0 0 0 0 31 0 0 0 0 31 0 0 0 0 31 62 0 0 0 31 54 0 0 0 49 0 0 0 0 49 0 0 0 0 31 52 0 0 0 31 63 0 0 0 31 0 0 0 0 31 32 0 0 0 31 0 0 0 0 31 0 0 0 0 16 34 0 0 0 17 45 0 0 0 16 0 0 0 0 16 0 0 0 0 16 0 0 0 0 16 14 0 0 0 17 5 0 0 0 16 6 0 0 0 1 0 0 0 0 1 80 0 0 0 1 0 0 0 0 2 0 0 0 0 1 108 0 0 0 83 0 0 1 1 83 0 0 1 1 83 0 0 1 1 83 0 0 1 1 83 0 0 1 1 83 0 0 1 1 83 0 0 1 1 83 0 0 1 1 83 0 0 1 1 83 0 0 1 1 1 111 100 1 0 
16 116 0 1 0 16 0 0 0 0 16 44 0 0 0 16 35 0 0 0 16 36 0 0 0 31 0 0 0 0 31 32 0 0 0 31 0 0 0 0 31 62 0 0 0 31 53 0 0 0 31 53 0 0 0 31 63 0 0 0 31 32 0 0 0 31 0 0 0 0 17 34 0 0 0 16 35 0 0 0 16 35 0 0 0 16 45 0 0 0 16 0 0 0 0 16 0 0 0 0 16 0 0 0 0 16 0 0 0 0 16 0 0 0 0 16 0 0 0 0 16 14 0 0 0 16 5 0 0 0 16 6 0 0 0 1 0 0 0 0 1 0 0 0 0 1 0 0 0 0 1 107 0 0 0 1 108 0 0 0 83 0 0 1 1 83 0 0 1 1 83 0 0 1 1 83 0 0 1 1 83 0 0 1 1 83 0 0 1 1 83 0 0 1 1 83 0 0 1 1 83 0 0 1 1 
17 116 0 1 0 17 0 0 0 0 16 0 0 0 0 16 0 0 0 0 17 44 0 0 0 16 36 0 0 0 31 0 0 0 0 31 0 0 0 0 31 0 0 0 0 31 32 0 0 0 31 0 0 0 0 31 0 0 0 0 31 0 0 0 0 16 34 0 0 0 17 45 0 0 0 16 0 0 0 0 16 0 0 0 0 16 0 0 0 0 17 0 0 0 0 16 0 0 0 0 18 0 0 0 0 16 0 0 0 0 18 0 0 0 0 16 0 0 0 0 16 0 0 0 0 16 0 0 0 0 16 14 0 0 0 16 5 0 0 0 16 6 0 0 0 2 0 0 0 0 1 0 0 0 0 2 0 0 0 0 1 107 0 0 0 1 107 0 0 0 1 108 0 0 0 83 0 0 1 1 83 0 0 1 1 83 0 0 1 1 83 0 0 1 1 83 0 0 1 1 83 0 0 1 1 
16 116 0 1 0 18 0 0 0 0 16 0 0 0 0 17 0 0 0 0 17 0 0 0 0 16 44 0 0 0 16 36 0 0 0 31 174 0 1 0 31 0 0 0 0 31 0 0 0 0 31 0 0 0 0 31 0 0 0 0 16 34 0 0 0 16 45 0 0 0 16 0 0 0 0 16 0 0 0 0 16 0 0 0 0 17 0 0 0 0 16 0 0 0 0 16 0 0 0 0 18 0 0 0 0 16 0 0 0 0 16 0 0 0 0 16 0 0 0 0 17 0 0 0 0 16 0 0 0 0 16 0 0 0 0 17 0 0 0 0 16 14 0 0 0 16 6 0 0 0 2 0 0 0 0 1 0 0 0 0 1 0 0 0 0 3 0 0 0 0 2 0 0 0 0 1 107 0 0 0 1 108 0 0 0 83 0 0 1 1 83 0 0 1 1 83 0 0 1 1 83 0 0 1 1 
17 116 0 1 0 16 0 0 0 0 16 0 0 0 0 17 0 0 0 0 16 0 0 0 0 16 0 0 0 0 16 44 0 0 0 16 35 0 0 0 17 35 0 0 0 17 35 0 0 0 16 35 0 0 0 16 35 0 0 0 16 45 0 0 0 17 0 0 0 0 16 0 0 0 0 17 0 0 0 0 18 0 0 0 0 16 0 0 0 0 17 0 0 0 0 16 0 0 0 0 17 0 0 0 0 16 0 0 0 0 16 12 0 0 0 16 10 0 0 0 16 10 0 0 0 16 10 0 0 0 16 10 0 0 0 16 13 0 0 0 17 0 0 0 0 16 14 0 0 0 16 5 0 0 0 16 5 0 0 0 16 6 0 0 0 1 0 0 0 0 1 0 0 0 0 1 0 0 0 0 2 0 0 0 0 1 107 0 0 0 1 107 0 0 0 1 107 0 0 0 1 107 100 1 0 
16 116 0 1 0 16 42 0 0 0 16 40 0 0 0 16 40 0 0 0 16 40 0 0 0 16 40 0 0 0 16 43 0 0 0 17 0 0 0 0 16 0 0 0 0 16 0 0 0 0 16 0 0 0 0 17 0 0 0 0 16 0 0 0 0 16 0 0 0 0 16 0 0 0 0 16 0 0 0 0 16 0 0 0 0 16 0 0 0 0 16 0 0 0 0 16 0 0 0 0 16 0 0 0 0 16 12 0 0 0 16 11 0 0 0 1 0 0 0 0 1 0 0 0 0 1 0 0 0 0 1 0 0 0 0 16 7 0 0 0 16 0 0 0 0 16 0 0 0 0 18 0 0 0 0 16 0 0 0 0 16 14 0 0 0 16 6 0 0 0 1 0 0 0 0 1 0 0 0 0 1 0 0 0 0 1 0 0 0 0 1 0 0 0 0 2 0 0 0 0 1 100 0 1 0 
16 116 0 1 0 16 38 0 0 0 31 33 0 0 0 31 32 0 0 0 31 0 0 0 0 31 81 0 0 0 16 39 0 0 0 16 43 0 0 0 16 0 0 0 0 17 0 0 0 0 16 0 0 0 0 16 0 0 0 0 17 0 0 0 0 16 0 0 0 0 16 0 0 0 0 17 0 0 0 0 16 12 0 0 0 16 10 0 0 0 16 10 0 0 0 16 10 0 0 0 16 10 0 0 0 16 11 0 0 0 1 0 0 0 0 1 0 0 0 0 1 0 0 0 0 1 0 0 0 0 1 0 0 0 0 16 9 0 0 0 16 10 0 0 0 16 10 0 0 0 17 10 0 0 0 16 13 0 0 0 16 0 0 0 0 16 14 0 0 0 16 6 0 0 0 1 0 0 0 0 1 0 0 0 0 2 0 0 0 0 1 0 0 0 0 1 0 0 0 0 2 100 101 1 0 
17 42 0 0 0 16 41 0 0 0 31 0 0 0 0 31 81 0 0 0 31 81 0 0 0 31 0 0 0 0 31 79 0 0 0 16 37 0 0 0 16 0 0 0 0 16 0 0 0 0 16 0 0 0 0 16 0 0 0 0 16 12 0 0 0 16 10 0 0 0 16 10 0 0 0 16 10 0 0 0 16 11 0 0 0 1 0 0 0 0 1 0 0 0 0 1 0 0 0 0 2 0 0 0 0 1 0 0 0 0 1 0 0 0 0 3 0 0 0 0 2 0 0 0 0 2 0 0 0 0 1 0 0 0 0 1 0 0 0 0 1 0 0 0 0 1 0 0 0 0 3 0 0 0 0 16 9 0 0 0 16 13 0 0 0 16 0 0 0 0 16 14 0 0 0 16 5 0 0 0 16 6 0 0 0 1 0 0 0 0 2 0 0 0 0 1 0 0 0 0 1 100 0 1 0 
17 38 0 0 0 31 81 0 0 0 31 32 0 0 0 31 79 0 0 0 31 32 0 0 0 31 0 0 0 0 31 81 0 0 0 16 37 0 0 0 16 0 0 0 0 16 0 0 0 0 17 0 0 0 0 18 0 0 0 0 16 8 0 0 0 1 0 0 0 0 3 0 0 0 0 2 0 0 0 0 3 0 0 0 0 1 0 0 0 0 2 0 0 0 0 1 0 0 0 0 1 0 0 0 0 1 0 0 0 0 1 0 0 0 0 1 0 0 0 0 1 0 0 0 0 1 80 0 0 0 1 0 0 0 0 1 0 0 0 0 1 0 0 0 0 2 0 0 0 0 1 0 0 0 0 1 0 0 0 0 16 7 0 0 0 16 0 0 0 0 16 0 0 0 0 16 0 0 0 0 16 14 0 0 0 16 5 0 0 0 16 5 0 0 0 16 5 0 0 0 16 5 0 0 0 
17 38 0 0 0 31 79 0 0 0 31 0 0 0 0 31 81 0 0 0 31 33 0 0 0 31 79 0 0 0 31 0 0 0 0 16 37 0 0 0 17 0 0 0 0 16 0 0 0 0 16 0 0 0 0 17 12 0 0 0 17 11 0 0 0 2 0 0 0 0 1 0 0 0 0 1 0 0 0 0 1 0 0 0 0 1 42 0 0 0 1 40 0 0 0 1 40 0 0 0 1 43 0 0 0 2 0 0 0 0 2 0 0 0 0 1 0 0 0 0 1 0 0 0 0 1 0 0 0 0 1 0 0 0 0 3 0 0 0 0 1 0 0 0 0 1 0 0 0 0 1 0 0 0 0 1 0 0 0 0 16 7 0 0 0 16 0 0 0 0 17 0 0 0 0 17 0 0 0 0 17 0 0 0 0 16 0 0 0 0 16 0 0 0 0 17 0 0 0 0 16 0 0 0 0 
17 44 0 0 0 16 36 0 0 0 31 32 0 0 0 31 32 0 0 0 31 0 0 0 0 31 81 0 0 0 31 0 0 0 0 16 37 0 0 0 16 0 0 0 0 16 0 0 0 0 16 0 0 0 0 16 8 0 0 0 1 0 0 0 0 1 0 0 0 0 1 42 0 0 0 1 40 0 0 0 1 40 0 0 0 1 41 0 0 0 31 0 0 0 0 31 0 0 0 0 1 39 0 0 0 1 43 0 0 0 1 0 0 0 0 2 0 0 0 0 2 0 0 0 0 2 0 0 0 0 1 0 0 0 0 1 0 0 0 0 1 0 0 0 0 1 0 0 0 0 1 0 0 0 0 16 4 0 0 0 17 15 0 0 0 17 0 0 0 0 18 0 0 0 0 16 0 0 0 0 16 0 0 0 0 16 12 0 0 0 16 10 0 0 0 16 10 0 0 0 16 10 0 0 0 
17 116 0 1 0 16 38 0 0 0 31 33 0 0 0 31 32 0 0 0 31 79 0 0 0 31 32 0 0 0 16 34 0 0 0 16 45 0 0 0 16 0 0 0 0 17 12 0 0 0 16 10 0 0 0 16 11 0 0 0 1 0 0 0 0 1 0 0 0 0 1 38 0 0 0 31 0 0 0 0 32 0 0 0 0 31 0 0 0 0 31 0 0 0 0 31 0 0 0 0 31 81 0 0 0 1 37 0 0 0 1 0 0 0 0 1 0 0 0 0 1 0 0 0 0 1 0 0 0 0 1 0 0 0 0 16 4 0 0 0 16 5 0 0 0 16 5 0 0 0 16 5 0 0 0 16 15 0 0 0 16 0 0 0 0 16 0 0 0 0 16 12 0 0 0 16 10 0 0 0 16 10 0 0 0 16 11 0 0 0 1 0 0 0 0 3 0 0 0 0 1 0 100 1 0 
16 116 0 1 0 16 44 0 0 0 17 35 0 0 0 17 35 0 0 0 17 35 0 0 0 16 35 0 0 0 16 45 0 0 0 16 0 0 0 0 17 12 0 0 0 16 11 0 0 0 1 0 0 0 0 2 0 0 0 0 1 0 0 0 0 1 42 0 0 0 1 41 0 0 0 31 0 0 0 0 31 0 0 0 0 31 0 0 0 0 33 0 0 0 0 31 0 0 0 0 31 0 0 0 0 1 37 0 0 0 1 0 0 0 0 1 0 0 0 0 1 0 0 0 0 16 4 0 0 0 16 5 0 0 0 18 15 0 0 0 16 0 0 0 0 17 0 0 0 0 16 0 0 0 0 16 12 0 0 0 16 10 0 0 0 16 10 0 0 0 16 11 0 0 0 2 0 0 0 0 1 0 0 0 0 1 0 0 0 0 1 0 0 0 0 2 0 0 0 0 1 0 100 1 0 
18 116 0 1 0 16 0 0 0 0 16 0 0 0 0 16 0 0 0 0 16 0 0 0 0 16 0 0 0 0 16 0 0 0 0 17 12 0 0 0 16 11 0 0 0 1 0 0 0 0 1 0 0 0 0 1 0 0 0 0 1 0 0 0 0 1 38 0 0 0 31 0 0 0 0 32 0 0 0 0 31 81 0 0 0 31 0 0 0 0 31 0 0 0 0 31 0 0 0 0 32 0 0 0 0 1 37 0 0 0 1 0 0 0 0 1 0 0 0 0 1 0 0 0 0 16 7 0 0 0 18 0 0 0 0 17 0 0 0 0 16 0 0 0 0 16 12 0 0 0 16 10 0 0 0 16 11 0 0 0 1 0 0 0 0 1 0 0 0 0 1 0 0 0 0 1 0 0 0 0 1 0 0 0 0 1 0 0 0 0 1 0 0 0 0 2 0 0 0 0 1 0 101 1 0 
16 116 0 1 0 16 0 0 0 0 17 0 0 0 0 18 0 0 0 0 16 0 0 0 0 17 0 0 0 0 16 0 0 0 0 16 8 0 0 0 1 0 0 0 0 3 0 0 0 0 2 0 0 0 0 1 0 0 0 0 1 42 0 0 0 1 41 0 0 0 31 0 0 0 0 31 0 0 0 0 31 0 0 0 0 32 0 0 0 0 31 0 0 0 0 31 0 0 0 0 1 34 0 0 0 1 45 0 0 0 1 0 0 0 0 1 0 0 0 0 16 4 0 0 0 16 15 0 0 0 16 0 0 0 0 16 12 0 0 0 16 10 0 0 0 16 11 0 0 0 1 0 0 0 0 1 0 0 0 0 1 0 0 0 0 1 80 0 0 0 1 0 0 0 0 1 0 0 0 0 2 0 0 0 0 3 0 0 0 0 1 0 0 0 0 1 0 0 0 0 1 0 100 1 0 
16 115 0 1 0 16 115 0 1 0 16 115 0 1 0 16 115 0 1 0 16 115 0 1 0 16 115 0 1 0 16 115 0 1 0 16 8 0 0 0 1 0 0 0 0 2 0 0 0 0 1 0 0 0 0 1 0 0 0 0 1 38 0 0 0 33 0 0 0 0 32 0 0 0 0 31 0 0 0 0 31 0 0 0 0 32 0 0 0 0 31 0 0 0 0 31 0 0 0 0 1 37 0 0 0 1 0 0 0 0 1 0 0 0 0 1 0 0 0 0 16 7 0 0 0 17 115 0 1 0 16 115 0 1 0 16 8 0 0 0 1 0 0 0 0 1 0 0 0 0 1 0 0 0 0 2 0 0 0 0 1 0 0 0 0 2 0 100 1 0 1 0 100 1 0 1 0 100 1 0 1 0 100 1 0 1 0 101 1 0 1 0 100 1 0 1 0 100 1 0 1 0 100 1 0 