60 40
1 0 0 1 0 2 100 0 1 0 2 100 0 1 0 2 100 0 1 0 1 100 0 1 0 1 0 0 1 0 1 119 0 1 0 1 100 0 1 0 1 100 0 1 0 1 100 0 1 0 2 100 0 1 0 1 100 0 1 0 1 100 0 1 0 1 100 0 1 0 2 119 0 1 0 2 100 0 1 0 2 100 0 1 0 2 100 0 1 0 1 100 0 1 0 1 100 0 1 0 1 100 0 1 0 1 100 0 1 0 2 100 0 1 0 1 100 0 1 0 1 100 0 1 0 2 100 0 1 0 1 100 0 1 0 2 100 0 1 0 1 100 0 1 0 2 100 0 1 0 1 100 0 1 0 2 100 0 1 0 2 100 0 1 0 1 100 0 1 0 2 100 0 1 0 1 100 0 1 0 2 100 0 1 0 2 100 0 1 0 2 100 0 1 0 2 100 0 1 0 1 100 0 1 0 1 100 0 1 0 2 100 0 1 0 1 100 0 1 0 1 110 0 1 0 97 0 0 1 0 1 111 0 0 0 2 112 0 0 0 1 112 0 0 0 1 0 0 0 0 3 0 0 0 0 2 0 0 0 0 1 161 0 0 0 1 112 0 0 0 2 112 0 0 0 83 0 0 0 0 83 0 0 0 0 1 112 0 0 0 2 112 0 0 0 1 112 0 0 0 
1 100 0 1 0 1 100 0 1 0 1 0 0 0 0 2 100 0 1 0 2 100 0 1 0 2 100 0 1 0 1 100 0 1 0 2 100 0 1 0 1 0 0 0 0 1 0 0 0 0 2 0 0 0 0 2 0 0 0 0 1 0 0 0 0 2 100 0 1 0 2 0 0 0 0 1 0 0 0 0 1 0 0 0 0 1 0 0 0 0 1 0 0 0 0 1 0 0 0 0 2 0 0 0 0 2 0 0 0 0 2 0 0 0 0 1 0 0 0 0 2 0 0 0 0 1 0 0 0 0 1 0 0 0 0 1 0 0 0 0 1 0 0 0 0 1 0 0 0 0 2 0 0 0 0 1 0 0 0 0 1 0 0 0 0 1 0 0 0 0 1 0 0 0 0 1 0 0 0 0 1 0 0 0 0 1 0 0 0 0 1 0 0 0 0 1 0 0 0 0 1 0 0 0 0 1 0 0 0 0 1 0 0 0 0 1 0 0 0 0 1 0 0 0 0 1 108 0 0 0 97 0 0 1 0 97 0 0 1 0 97 0 0 1 0 1 111 0 0 0 1 112 0 0 0 1 112 0 0 0 2 113 0 0 0 97 0 0 1 0 97 0 0 1 0 85 0 0 1 1 85 0 0 1 1 97 0 0 1 0 97 0 0 1 0 97 0 0 1 0 
1 0 0 1 0 1 100 0 1 0 1 100 0 1 0 1 100 0 1 0 1 100 0 1 0 1 0 0 0 0 1 0 0 0 0 2 0 0 0 0 1 0 0 0 0 1 100 0 1 0 1 0 0 0 0 2 0 0 0 0 2 0 0 0 0 1 0 0 0 0 1 0 0 0 0 2 0 0 0 0 1 100 0 1 0 1 0 0 0 0 1 79 0 0 0 2 0 0 0 0 2 100 0 1 0 1 0 0 0 0 1 0 0 0 0 1 0 0 0 0 1 0 0 0 0 1 0 0 0 0 1 0 0 0 0 3 0 0 0 0 1 0 0 0 0 1 0 0 0 0 1 0 0 0 0 1 0 0 0 0 1 0 0 0 0 2 0 0 0 0 1 0 0 0 0 2 0 0 0 0 2 0 0 0 0 1 0 0 0 0 1 0 0 0 0 1 0 0 0 0 1 0 0 0 0 2 0 0 0 0 2 0 0 0 0 2 0 0 0 0 1 0 0 0 0 2 0 0 0 0 1 107 0 0 0 1 107 0 0 0 1 108 0 0 0 97 0 0 1 0 97 0 0 1 0 97 0 0 1 0 97 0 0 1 0 83 0 0 1 1 83 0 0 1 1 83 0 0 1 1 83 0 0 1 1 83 0 0 1 1 1 28 0 0 0 1 23 0 0 0 
1 100 0 1 0 1 0 0 0 0 1 100 0 1 0 1 119 0 1 0 80 119 0 1 0 1 0 0 0 0 1 0 0 0 0 1 0 0 0 0 80 0 0 0 0 1 0 0 0 0 2 0 0 0 0 2 100 0 1 0 2 0 0 0 0 1 0 0 0 0 1 0 0 0 0 1 0 0 0 0 1 0 0 0 0 2 0 0 0 0 2 0 0 0 0 2 0 0 0 0 1 0 0 0 0 1 0 0 0 0 3 0 0 0 0 1 0 0 0 0 2 0 0 0 0 2 0 0 0 0 1 0 0 0 0 1 0 0 0 0 2 0 0 0 0 1 0 0 0 0 2 0 0 0 0 80 0 0 0 0 1 0 0 0 0 1 0 0 0 0 2 0 0 0 0 1 0 0 0 0 1 0 0 0 0 1 0 0 0 0 3 0 0 0 0 1 0 0 0 0 1 0 0 0 0 1 0 0 0 0 2 0 0 0 0 2 0 0 0 0 1 0 0 0 0 1 0 0 0 0 2 0 0 0 0 2 0 0 0 0 2 0 0 0 0 1 107 0 0 0 2 108 0 0 0 83 0 0 1 1 83 0 0 1 1 83 0 0 1 1 83 0 0 1 1 83 0 0 1 1 83 0 0 1 1 83 0 0 1 1 83 0 0 1 1 83 0 0 1 1 
1 100 0 1 0 1 100 0 1 0 2 100 0 1 0 2 0 0 0 0 3 0 0 0 0 1 0 0 0 0 2 0 0 0 0 2 100 0 1 0 2 0 0 0 0 2 0 0 0 0 2 0 0 0 0 1 0 0 0 0 1 0 0 0 0 1 0 0 0 0 1 0 0 0 0 2 119 0 1 0 2 0 0 0 0 2 0 0 0 0 2 0 0 0 0 1 0 0 0 0 2 0 0 0 0 2 0 0 0 0 1 0 0 0 0 1 0 0 0 0 1 0 0 0 0 3 0 0 0 0 1 0 0 0 0 1 0 0 0 0 1 100 0 1 0 1 0 0 0 0 1 0 0 0 0 2 0 0 0 0 1 0 0 0 0 1 0 0 0 0 1 0 0 0 0 1 0 0 0 0 0 80 0 0 0 1 0 0 0 0 1 0 0 0 0 1 0 0 0 0 1 0 0 0 0 2 0 0 0 0 1 0 0 0 0 1 0 0 0 0 1 0 0 0 0 2 0 0 0 0 1 0 0 0 0 1 0 0 0 0 1 0 0 0 0 2 0 0 0 0 1 0 0 0 0 1 108 0 0 0 83 0 0 1 1 83 0 0 1 1 83 0 0 1 1 83 0 0 1 1 83 0 0 1 1 83 0 0 1 1 83 0 0 1 1 83 0 0 1 1 
1 100 0 1 0 1 0 0 0 0 2 0 0 0 0 1 0 0 0 0 1 0 0 0 0 1 100 0 1 0 1 0 0 0 0 1 100 0 1 0 1 0 0 0 0 1 0 0 0 0 80 0 0 0 0 1 0 0 0 0 1 0 0 0 0 1 100 0 1 0 2 0 0 0 0 2 0 0 0 0 1 0 0 0 0 1 0 0 0 0 2 0 0 0 0 3 0 0 0 0 1 0 0 0 0 2 0 0 0 0 2 0 0 0 0 1 0 0 0 0 2 0 0 0 0 1 0 0 0 0 1 0 0 0 0 1 0 0 0 0 1 0 0 0 0 1 0 0 0 0 1 0 0 0 0 1 0 0 0 0 2 0 0 0 0 1 0 0 0 0 2 0 0 0 0 1 0 0 0 0 1 0 0 0 0 1 0 0 0 0 1 0 0 0 0 1 0 0 0 0 1 0 0 0 0 2 0 0 0 0 1 0 0 0 0 1 0 0 0 0 1 0 0 0 0 1 0 0 0 0 1 79 0 0 0 1 0 0 0 0 2 0 0 0 0 1 0 0 0 0 3 0 0 0 0 1 0 0 0 0 1 107 0 0 0 1 107 0 0 0 2 107 0 0 0 1 107 0 0 0 1 107 0 0 0 1 107 0 0 0 1 107 0 0 0 1 107 0 0 0 
1 100 0 1 0 3 100 0 1 0 2 0 0 0 0 2 0 0 0 0 1 0 0 0 0 1 0 0 0 0 1 0 0 0 0 2 0 0 0 0 1 0 0 0 0 1 79 0 0 0 1 0 0 0 0 1 100 0 1 0 1 0 0 0 0 2 0 0 0 0 2 0 0 0 0 80 0 0 0 0 1 0 0 0 0 1 0 0 0 0 1 100 0 1 0 1 0 0 0 0 1 0 0 0 0 1 0 0 0 0 2 0 0 0 0 2 0 0 0 0 1 0 0 0 0 1 0 0 0 0 1 0 0 0 0 3 0 0 0 0 1 0 0 0 0 2 0 0 0 0 2 0 0 0 0 1 79 0 0 0 1 0 0 0 0 1 0 0 0 0 1 0 0 0 0 16 4 0 0 0 16 5 0 0 0 16 5 0 0 0 16 5 0 0 0 16 5 0 0 0 16 5 0 0 0 18 5 0 0 0 16 5 0 0 0 16 5 0 0 0 16 5 0 0 0 17 5 0 0 0 17 5 0 0 0 16 5 0 0 0 16 5 0 0 0 17 5 0 0 0 16 5 0 0 0 16 5 0 0 0 18 5 0 0 0 16 5 0 0 0 17 5 0 0 0 16 5 0 0 0 17 5 0 0 0 17 5 0 0 0 16 5 0 0 0 16 5 0 0 0 
1 100 0 1 0 1 0 0 0 0 1 0 0 0 0 2 0 0 0 0 1 100 0 1 0 1 0 0 0 0 80 0 0 0 0 1 0 0 0 0 1 100 0 1 0 1 0 0 0 0 2 0 0 0 0 1 0 0 0 0 1 0 0 0 0 2 0 0 0 0 3 0 0 0 0 1 0 0 0 0 2 0 0 0 0 1 0 0 0 0 1 0 0 0 0 1 0 0 0 0 80 0 0 0 0 2 0 0 0 0 2 0 0 0 0 3 0 0 0 0 1 0 0 0 0 1 0 0 0 0 1 119 0 1 0 1 0 0 0 0 1 0 0 0 0 2 0 0 0 0 1 0 0 0 0 1 0 0 0 0 3 0 0 0 0 2 0 0 0 0 1 0 0 0 0 16 7 0 0 0 16 0 0 0 0 17 0 0 0 0 17 0 0 0 0 16 0 0 0 0 16 0 0 0 0 17 0 0 0 0 17 0 0 0 0 16 0 0 0 0 16 0 0 0 0 16 0 0 0 0 16 0 0 0 0 16 0 0 0 0 17 0 0 0 0 16 0 0 0 0 16 0 0 0 0 18 0 0 0 0 17 0 0 0 0 16 0 0 0 0 17 0 0 0 0 17 0 0 0 0 18 0 0 0 0 16 0 0 0 0 17 0 0 0 0 17 0 0 0 0 
1 100 0 1 0 1 0 0 0 0 1 100 0 1 0 1 0 0 0 0 2 0 0 0 0 1 0 0 0 0 1 119 0 1 0 1 0 0 0 0 1 0 0 0 0 1 0 0 0 0 1 100 0 1 0 1 119 0 1 0 1 0 0 0 0 2 0 0 0 0 1 0 0 0 0 1 0 0 0 0 2 0 0 0 0 1 0 0 0 0 2 0 0 0 0 2 0 0 0 0 2 0 0 0 0 1 0 0 0 0 1 0 0 0 0 2 0 0 0 0 1 0 0 0 0 1 0 0 0 0 1 0 0 0 0 1 0 0 0 0 1 0 0 0 0 1 0 0 0 0 1 100 0 1 0 1 0 0 0 0 1 0 0 0 0 1 0 0 0 0 1 0 0 0 0 16 7 0 0 0 16 0 0 0 0 18 12 0 0 0 16 10 0 0 0 16 10 0 0 0 16 10 0 0 0 16 10 0 0 0 16 10 0 0 0 16 10 0 0 0 16 10 0 0 0 18 10 0 0 0 16 10 0 0 0 16 10 0 0 0 17 10 0 0 0 17 10 0 0 0 16 10 0 0 0 16 10 0 0 0 18 10 0 0 0 16 10 0 0 0 17 10 0 0 0 16 10 0 0 0 16 10 0 0 0 16 10 0 0 0 16 10 0 0 0 16 10 0 0 0 
1 100 0 1 0 1 0 0 0 0 1 0 0 0 0 1 0 0 0 0 2 0 0 0 0 1 100 0 1 0 1 0 0 0 0 2 0 0 0 0 1 0 0 0 0 1 100 0 1 0 1 119 0 1 0 1 0 0 0 0 2 0 0 0 0 1 0 0 0 0 1 0 0 0 0 1 0 0 0 0 1 0 0 0 0 1 0 0 0 0 80 0 0 0 0 2 0 0 0 0 2 0 0 0 0 1 0 0 0 0 2 0 0 0 0 2 0 0 0 0 1 100 0 1 0 1 0 0 0 0 1 0 0 0 0 2 0 0 0 0 2 0 0 0 0 2 0 0 0 0 1 0 0 0 0 2 0 0 0 0 1 100 0 1 0 1 0 0 0 0 1 0 0 0 0 16 7 0 0 0 17 0 0 0 0 16 8 0 0 0 1 0 0 0 0 1 0 0 0 0 1 0 0 0 0 1 0 0 0 0 1 0 0 0 0 1 0 0 0 0 1 0 0 0 0 1 0 0 0 0 2 0 0 0 0 1 0 0 0 0 1 0 0 0 0 3 0 0 0 0 1 0 0 0 0 2 0 0 0 0 1 0 0 0 0 1 0 0 0 0 3 0 0 0 0 1 0 0 0 0 1 0 0 0 0 1 0 0 0 0 1 0 0 0 0 1 100 0 1 0 
1 100 0 1 0 1 0 0 0 0 1 0 0 0 0 1 100 0 1 0 2 0 0 0 0 1 0 0 0 0 2 100 0 1 0 2 0 0 0 0 1 0 0 0 0 1 0 0 0 0 1 0 0 0 0 1 0 0 0 0 1 0 0 0 0 1 119 0 1 0 1 0 0 0 0 1 0 0 0 0 1 100 0 1 0 1 0 0 0 0 2 0 0 0 0 1 0 0 0 0 1 0 0 0 0 3 0 0 0 0 1 0 0 0 0 1 0 0 0 0 1 0 0 0 0 1 0 0 0 0 2 0 0 0 0 2 0 0 0 0 3 0 0 0 0 1 0 0 0 0 1 0 0 0 0 1 0 0 0 0 1 119 0 1 0 1 0 0 0 0 2 0 0 0 0 16 7 0 0 0 17 0 0 0 0 16 8 0 0 0 1 0 0 0 0 3 0 0 0 0 1 79 0 0 0 1 0 0 0 0 1 0 0 0 0 2 0 0 0 0 1 0 0 0 0 80 0 0 0 0 1 0 0 0 0 1 0 0 0 0 1 0 0 0 0 1 0 0 0 0 1 0 0 0 0 1 0 0 0 0 2 0 0 0 0 1 0 0 0 0 1 0 0 0 0 1 0 0 0 0 3 0 0 0 0 1 0 0 0 0 1 0 0 0 0 1 100 0 1 0 
1 100 0 1 0 1 0 0 0 0 2 0 0 0 0 1 79 0 0 0 1 100 0 1 0 1 0 0 0 0 2 0 0 0 0 1 0 0 0 0 1 100 0 1 0 1 0 0 0 0 1 100 0 1 0 2 0 0 0 0 1 0 0 0 0 1 0 0 0 0 2 0 0 0 0 1 0 0 0 0 1 0 0 0 0 1 0 0 0 0 2 0 0 0 0 1 0 0 0 0 1 0 0 0 0 1 0 0 0 0 1 0 0 0 0 1 0 0 0 0 1 0 0 0 0 1 0 0 0 0 2 0 0 0 0 80 0 0 0 0 1 0 0 0 0 1 0 0 0 0 2 0 0 0 0 1 0 0 0 0 1 0 0 0 0 1 0 0 0 0 1 0 0 0 0 16 7 0 0 0 16 0 0 0 0 16 8 0 0 0 1 0 0 0 0 1 0 0 0 0 1 0 0 0 0 1 0 0 0 0 3 0 0 0 0 1 0 0 0 0 2 0 0 0 0 1 0 0 0 0 3 0 0 0 0 1 0 0 0 0 3 0 0 0 0 1 0 0 0 0 2 0 0 0 0 1 0 0 0 0 1 0 0 0 0 1 0 0 0 0 2 0 0 0 0 1 0 0 0 0 2 0 0 0 0 1 0 0 0 0 1 0 0 0 0 1 119 0 1 0 
2 100 0 1 0 1 0 0 0 0 1 0 0 0 0 1 0 0 0 0 1 0 0 0 0 1 100 0 1 0 2 0 0 0 0 80 0 0 0 0 1 0 0 0 0 1 0 0 0 0 1 100 0 1 0 1 100 0 1 0 1 0 0 0 0 1 100 0 1 0 1 0 0 0 0 1 0 0 0 0 1 0 0 0 0 2 0 0 0 0 1 0 0 0 0 2 0 0 0 0 1 0 0 0 0 1 100 0 1 0 1 0 0 0 0 3 0 0 0 0 1 0 0 0 0 1 0 0 0 0 3 0 0 0 0 1 0 0 0 0 1 0 0 0 0 2 0 0 0 0 1 0 0 0 0 1 0 0 0 0 2 0 0 0 0 1 0 0 0 0 1 0 0 0 0 16 7 0 0 0 16 0 0 0 0 16 8 0 0 0 1 0 0 0 0 2 0 0 0 0 1 0 0 0 0 1 0 0 0 0 1 0 0 0 0 1 0 0 0 0 80 0 0 0 0 1 0 0 0 0 2 0 0 0 0 1 0 0 0 0 2 0 0 0 0 1 0 0 0 0 1 0 0 0 0 1 0 0 0 0 3 0 0 0 0 1 0 0 0 0 1 0 0 0 0 1 0 0 0 0 1 0 0 0 0 1 0 0 0 0 1 0 0 0 0 1 100 0 1 0 
2 100 0 1 0 2 0 0 0 0 1 0 0 0 0 1 100 0 1 0 1 100 0 1 0 1 0 0 0 0 2 0 0 0 0 1 0 0 0 0 1 0 0 0 0 1 0 0 0 0 80 0 0 0 0 2 0 0 0 0 2 0 0 0 0 1 0 0 0 0 1 0 0 0 0 80 0 0 0 0 2 0 0 0 0 2 0 0 0 0 1 0 0 0 0 1 0 0 0 0 1 0 0 0 0 1 79 0 0 0 1 0 0 0 0 1 0 0 0 0 80 0 0 0 0 2 0 0 0 0 1 0 0 0 0 2 0 0 0 0 1 0 0 0 0 1 0 0 0 0 1 0 0 0 0 1 0 0 0 0 1 0 0 0 0 1 0 0 0 0 1 0 0 0 0 16 7 0 0 0 16 0 0 0 0 17 8 0 0 0 1 0 0 0 0 1 0 0 0 0 1 0 0 0 0 2 0 0 0 0 1 0 0 0 0 2 0 0 0 0 1 0 0 0 0 1 0 0 0 0 3 0 0 0 0 80 0 0 0 0 1 0 0 0 0 1 0 0 0 0 1 79 0 0 0 3 0 0 0 0 1 0 0 0 0 2 0 0 0 0 2 0 0 0 0 1 0 0 0 0 1 0 0 0 0 1 119 0 1 0 1 0 0 0 0 1 100 0 1 0 
1 100 0 1 0 2 0 0 0 0 2 0 0 0 0 1 0 0 0 0 1 0 0 0 0 1 0 0 0 0 2 0 0 0 0 1 0 0 0 0 3 100 0 1 0 2 0 0 0 0 2 0 0 0 0 2 0 0 0 0 1 0 0 0 0 1 0 0 0 0 1 0 0 0 0 2 0 0 0 0 2 0 0 0 0 1 0 0 0 0 80 0 0 0 0 1 0 0 0 0 1 0 0 0 0 1 0 0 0 0 1 0 0 0 0 1 0 0 0 0 3 0 0 0 0 1 0 0 0 0 1 0 0 0 0 1 0 0 0 0 1 0 0 0 0 1 0 0 0 0 3 0 0 0 0 1 0 0 0 0 1 0 0 0 0 2 0 0 0 0 1 0 0 0 0 16 7 0 0 0 16 0 0 0 0 17 8 0 0 0 1 0 0 0 0 1 0 0 0 0 1 0 0 0 0 2 0 0 0 0 2 0 0 0 0 2 0 0 0 0 3 0 0 0 0 80 0 0 0 0 1 0 0 0 0 1 0 0 0 0 3 0 0 0 0 1 0 0 0 0 2 0 0 0 0 1 0 0 0 0 1 0 0 0 0 1 0 0 0 0 2 0 0 0 0 2 0 0 0 0 2 0 0 0 0 1 0 0 0 0 1 0 0 0 0 1 100 0 1 0 
1 112 0 1 0 1 112 0 0 0 1 112 0 0 0 1 112 0 0 0 1 112 0 0 0 1 0 0 0 0 1 100 0 1 0 1 0 0 0 0 1 0 0 0 0 1 0 0 0 0 1 0 0 0 0 1 0 0 0 0 1 100 0 1 0 1 0 0 0 0 1 0 0 0 0 1 0 0 0 0 1 0 0 0 0 1 0 0 0 0 3 0 0 0 0 1 0 0 0 0 80 0 0 0 0 1 0 0 0 0 1 0 0 0 0 2 0 0 0 0 1 0 0 0 0 2 0 0 0 0 1 0 0 0 0 1 100 0 1 0 1 0 0 0 0 80 0 0 0 0 1 0 0 0 0 1 0 0 0 0 2 0 0 0 0 1 0 0 0 0 1 0 0 0 0 16 7 0 0 0 16 0 0 0 0 18 8 0 0 0 2 0 0 0 0 1 0 0 0 0 3 0 0 0 0 1 0 0 0 0 1 0 0 0 0 1 0 0 0 0 2 0 0 0 0 2 0 0 0 0 1 0 0 0 0 2 0 0 0 0 1 0 0 0 0 1 0 0 0 0 1 0 0 0 0 2 0 0 0 0 1 0 0 0 0 1 0 0 0 0 1 100 0 1 0 1 0 0 0 0 2 0 0 0 0 2 0 0 0 0 1 119 0 1 0 1 100 0 1 0 
83 0 0 1 1 83 0 0 1 1 83 0 0 1 1 83 0 0 1 1 83 0 0 1 1 2 111 0 0 0 1 112 0 0 0 1 112 0 0 0 1 112 0 0 0 1 112 0 0 0 1 112 0 0 0 1 0 0 0 0 2 0 0 0 0 1 0 0 0 0 1 0 0 0 0 1 0 0 0 0 80 0 0 0 0 1 0 0 0 0 1 0 0 0 0 1 0 0 0 0 1 0 0 0 0 1 0 0 0 0 1 0 0 0 0 1 0 0 0 0 1 0 0 0 0 1 0 0 0 0 1 0 0 0 0 1 0 0 0 0 1 0 0 0 0 1 0 0 0 0 3 0 0 0 0 1 0 0 0 0 2 0 0 0 0 1 0 0 0 0 1 0 0 0 0 16 7 0 0 0 16 0 0 0 0 17 8 0 0 0 1 0 0 0 0 1 0 0 0 0 1 0 0 0 0 1 0 0 0 0 1 0 0 0 0 1 0 0 0 0 1 0 0 0 0 1 0 0 0 0 1 79 0 0 0 1 0 0 0 0 3 0 0 0 0 1 0 0 0 0 2 0 0 0 0 1 0 0 0 0 1 0 0 0 0 2 0 0 0 0 1 0 0 0 0 1 0 0 0 0 2 0 0 0 0 2 0 0 0 0 1 100 0 1 0 1 100 0 1 0 
83 0 0 1 1 83 0 0 1 1 83 0 0 1 1 83 0 0 1 1 83 0 0 1 1 83 0 0 1 1 83 0 0 1 1 83 0 0 1 1 83 0 0 1 1 83 0 0 1 1 83 0 0 1 1 1 111 0 0 0 2 112 0 0 0 1 112 0 0 0 2 0 0 0 0 1 0 0 0 0 2 0 0 0 0 1 0 0 0 0 1 119 0 1 0 1 0 0 0 0 1 0 0 0 0 1 0 0 0 0 2 0 0 0 0 1 0 0 0 0 2 0 0 0 0 1 0 0 0 0 1 0 0 0 0 1 0 0 0 0 2 0 0 0 0 1 0 0 0 0 1 0 0 0 0 1 0 0 0 0 1 0 0 0 0 2 0 0 0 0 2 0 0 0 0 17 7 0 0 0 18 0 0 0 0 16 8 0 0 0 1 0 0 0 0 1 0 0 0 0 1 0 0 0 0 2 0 0 0 0 1 0 0 0 0 1 0 0 0 0 3 0 0 0 0 1 0 0 0 0 1 0 0 0 0 1 0 0 0 0 2 0 0 0 0 1 0 0 0 0 2 0 0 0 0 1 0 0 0 0 2 0 0 0 0 1 0 0 0 0 1 0 0 0 0 3 0 0 0 0 1 0 0 0 0 1 0 0 0 0 1 100 0 1 0 1 119 0 1 0 
1 107 0 1 0 1 107 0 0 0 1 108 0 0 0 83 0 0 1 1 83 0 0 1 1 83 0 0 1 1 83 0 0 1 1 83 0 0 1 1 83 0 0 1 1 83 0 0 1 1 83 0 0 1 1 83 0 0 1 1 83 0 0 1 1 83 0 0 1 1 1 111 0 0 0 1 0 0 0 0 2 0 0 0 0 1 0 0 0 0 1 0 0 0 0 3 0 0 0 0 1 0 0 0 0 1 0 0 0 0 1 0 0 0 0 1 0 0 0 0 1 0 0 0 0 1 0 0 0 0 1 0 0 0 0 2 0 0 0 0 1 0 0 0 0 2 0 0 0 0 2 0 0 0 0 2 0 0 0 0 2 0 0 0 0 2 0 0 0 0 1 0 0 0 0 16 7 0 0 0 16 0 0 0 0 16 8 0 0 0 1 0 0 0 0 2 0 0 0 0 2 0 0 0 0 1 0 0 0 0 1 0 0 0 0 3 0 0 0 0 1 0 0 0 0 2 0 0 0 0 2 0 0 0 0 1 0 0 0 0 3 0 0 0 0 1 0 0 0 0 1 0 0 0 0 1 0 0 0 0 1 0 0 0 0 1 0 0 0 0 1 0 0 0 0 1 0 0 0 0 2 0 0 0 0 1 0 0 0 0 1 119 0 1 0 1 100 0 1 0 
1 100 0 1 0 2 0 0 0 0 1 79 0 0 0 2 107 0 0 0 1 107 0 0 0 1 107 0 0 0 1 107 0 0 0 1 108 0 0 0 83 0 0 1 1 83 0 0 1 1 83 0 0 1 1 83 0 0 1 1 83 0 0 1 1 83 0 0 1 1 83 0 0 1 1 1 111 0 0 0 1 0 0 0 0 3 0 0 0 0 1 0 0 0 0 1 0 0 0 0 1 0 0 0 0 1 0 0 0 0 1 0 0 0 0 1 100 0 1 0 1 0 0 0 0 1 0 0 0 0 1 0 0 0 0 80 0 0 0 0 2 0 0 0 0 1 0 0 0 0 1 0 0 0 0 2 0 0 0 0 1 0 0 0 0 2 0 0 0 0 1 0 0 0 0 16 7 0 0 0 17 0 0 0 0 16 8 0 0 0 1 0 0 0 0 1 0 0 0 0 1 0 0 0 0 2 0 0 0 0 1 0 0 0 0 1 0 0 0 0 2 0 0 0 0 2 0 0 0 0 1 0 0 0 0 1 100 0 1 0 1 0 0 0 0 1 0 0 0 0 2 0 0 0 0 1 0 0 0 0 3 0 0 0 0 2 0 0 0 0 1 0 0 0 0 1 100 0 1 0 1 0 0 0 0 1 0 0 0 0 1 100 0 1 0 1 100 0 1 0 
1 100 0 1 0 1 0 0 0 0 1 0 0 0 0 2 0 0 0 0 1 0 0 0 0 2 0 0 0 0 2 0 0 0 0 1 0 0 0 0 1 107 0 0 0 1 108 0 0 0 83 0 0 1 1 83 0 0 1 1 83 0 0 1 1 83 0 0 1 1 83 0 0 1 1 83 0 0 1 1 1 111 0 0 0 1 0 0 0 0 1 0 0 0 0 1 0 0 0 0 3 0 0 0 0 1 0 0 0 0 1 0 0 0 0 1 0 0 0 0 1 0 0 0 0 2 0 0 0 0 1 0 0 0 0 1 0 0 0 0 1 0 0 0 0 1 0 0 0 0 2 0 0 0 0 1 0 0 0 0 1 0 0 0 0 2 0 0 0 0 1 0 0 0 0 16 7 0 0 0 16 0 0 0 0 16 8 0 0 0 1 0 0 0 0 1 0 0 0 0 1 0 0 0 0 1 0 0 0 0 1 0 0 0 0 2 0 0 0 0 2 0 0 0 0 2 0 0 0 0 1 0 0 0 0 1 0 0 0 0 2 0 0 0 0 1 0 0 0 0 1 0 0 0 0 1 0 0 0 0 2 0 0 0 0 2 0 0 0 0 2 0 0 0 0 2 0 0 0 0 1 0 0 0 0 1 0 0 0 0 1 0 0 0 0 1 100 0 1 0 
1 100 0 1 0 1 0 0 0 0 1 0 0 0 0 1 0 0 0 0 1 0 0 0 0 2 0 0 0 0 1 0 0 0 0 1 0 0 0 0 2 0 0 0 0 1 0 0 0 0 1 107 0 0 0 1 107 0 0 0 1 108 0 0 0 83 0 0 1 1 83 0 0 1 1 83 0 0 1 1 83 0 0 1 1 1 111 0 0 0 1 0 0 0 0 1 0 0 0 0 1 0 0 0 0 1 0 0 0 0 2 0 0 0 0 1 0 0 0 0 2 0 0 0 0 1 0 0 0 0 1 0 0 0 0 1 0 0 0 0 1 0 0 0 0 1 100 0 1 0 1 0 0 0 0 1 0 0 0 0 2 0 0 0 0 1 0 0 0 0 1 0 0 0 0 16 7 0 0 0 17 0 0 0 0 16 8 0 0 0 1 0 0 0 0 1 0 0 0 0 3 0 0 0 0 2 0 0 0 0 1 0 0 0 0 1 0 0 0 0 1 0 0 0 0 1 0 0 0 0 2 0 0 0 0 1 0 0 0 0 1 0 0 0 0 2 0 0 0 0 1 0 0 0 0 1 0 0 0 0 1 0 0 0 0 2 0 0 0 0 1 0 0 0 0 2 0 0 0 0 2 0 0 0 0 2 0 0 0 0 1 0 0 0 0 1 100 0 1 0 
16 5 0 0 0 16 5 0 0 0 16 5 0 0 0 16 5 0 0 0 16 5 0 0 0 18 5 0 0 0 16 5 0 0 0 16 5 0 0 0 16 5 0 0 0 16 5 0 0 0 16 6 0 0 0 1 0 0 0 0 2 0 0 0 0 1 108 0 0 0 83 0 0 1 1 83 0 0 1 1 83 0 0 1 1 83 0 0 1 1 1 111 0 0 0 1 112 0 0 0 1 112 0 0 0 1 0 0 0 0 1 0 0 0 0 1 0 0 0 0 1 0 0 0 0 1 0 0 0 0 1 0 0 0 0 1 112 0 0 0 1 112 0 0 0 1 112 0 0 0 1 112 0 0 0 1 112 0 0 0 1 112 0 0 0 1 112 0 0 0 1 112 0 0 0 68 0 0 0 0 68 0 0 0 0 68 0 0 0 0 1 112 0 0 0 1 112 0 0 0 1 112 0 0 0 1 112 0 0 0 1 112 0 0 0 1 112 0 0 0 2 112 0 0 0 1 112 0 0 0 1 112 0 0 0 1 112 0 0 0 1 112 0 0 0 1 112 0 0 0 1 112 0 0 0 1 112 0 0 0 1 112 0 0 0 1 112 0 0 0 1 112 0 0 0 1 112 0 0 0 1 112 0 0 0 1 112 0 0 0 1 112 0 0 0 1 112 0 1 0 
17 0 0 0 0 17 0 0 0 0 16 0 0 0 0 18 0 0 0 0 17 0 0 0 0 17 0 0 0 0 17 0 0 0 0 16 0 0 0 0 16 0 0 0 0 16 0 0 0 0 16 8 0 0 0 1 0 0 0 0 1 0 0 0 0 1 110 0 0 0 83 0 0 1 1 83 0 0 1 1 83 0 0 1 1 83 0 0 1 1 83 0 0 1 1 83 0 0 1 1 83 0 0 1 1 1 111 0 0 0 3 112 0 0 0 1 112 0 0 0 1 112 0 0 0 1 112 0 0 0 1 113 0 0 0 83 0 0 1 1 83 0 0 1 1 83 0 0 1 1 83 0 0 1 1 83 0 0 1 1 83 0 0 1 1 83 0 0 1 1 83 0 0 1 1 68 0 0 0 0 68 0 0 0 0 68 0 0 0 0 83 0 0 1 1 83 0 0 1 1 83 0 0 1 1 83 0 0 1 1 83 0 0 1 1 83 0 0 1 1 83 0 0 1 1 83 0 0 1 1 83 0 0 1 1 83 0 0 1 1 83 0 0 1 1 83 0 0 1 1 83 0 0 1 1 83 0 0 1 1 83 0 0 1 1 83 0 0 1 1 83 0 0 1 1 83 0 0 1 1 83 0 0 1 1 83 0 0 1 1 83 0 0 1 1 83 0 0 1 1 
16 10 0 0 0 16 10 0 0 0 16 10 0 0 0 16 10 0 0 0 17 10 0 0 0 16 10 0 0 0 16 10 0 0 0 16 10 0 0 0 16 13 0 0 0 17 0 0 0 0 16 8 0 0 0 1 0 0 0 0 2 0 0 0 0 1 0 0 0 0 1 108 0 0 0 83 0 0 1 1 83 0 0 1 1 83 0 0 1 1 83 0 0 1 1 83 0 0 1 1 83 0 0 1 1 83 0 0 1 1 83 0 0 1 1 83 0 0 1 1 83 0 0 1 1 83 0 0 1 1 83 0 0 1 1 83 0 0 1 1 83 0 0 1 1 83 0 0 1 1 83 0 0 1 1 83 0 0 1 1 83 0 0 1 1 83 0 0 1 1 83 0 0 1 1 68 0 0 0 0 68 0 0 0 0 68 0 0 0 0 83 0 0 1 1 83 0 0 1 1 83 0 0 1 1 83 0 0 1 1 83 0 0 1 1 83 0 0 1 1 83 0 0 1 1 83 0 0 1 1 83 0 0 1 1 83 0 0 1 1 83 0 0 1 1 83 0 0 1 1 83 0 0 1 1 83 0 0 1 1 83 0 0 1 1 83 0 0 1 1 83 0 0 1 1 83 0 0 1 1 83 0 0 1 1 83 0 0 1 1 83 0 0 1 1 83 0 0 1 1 
1 100 0 1 0 1 0 0 0 0 1 0 0 0 0 1 0 0 0 0 1 0 0 0 0 1 0 0 0 0 1 0 0 0 0 1 0 0 0 0 16 7 0 0 0 16 0 0 0 0 16 8 0 0 0 1 0 0 0 0 1 0 0 0 0 1 0 0 0 0 1 0 0 0 0 1 108 0 0 0 83 0 0 1 1 83 0 0 1 1 83 0 0 1 1 83 0 0 1 1 83 0 0 1 1 83 0 0 1 1 83 0 0 1 1 83 0 0 1 1 83 0 0 1 1 83 0 0 1 1 83 0 0 1 1 83 0 0 1 1 83 0 0 1 1 83 0 0 1 1 83 0 0 1 1 83 0 0 1 1 83 0 0 1 1 83 0 0 1 1 83 0 0 1 1 68 0 0 0 0 68 0 0 0 0 68 0 0 0 0 83 0 0 1 1 83 0 0 1 1 83 0 0 1 1 83 0 0 1 1 83 0 0 1 1 83 0 0 1 1 83 0 0 1 1 83 0 0 1 1 83 0 0 1 1 83 0 0 1 1 83 0 0 1 1 83 0 0 1 1 83 0 0 1 1 83 0 0 1 1 83 0 0 1 1 83 0 0 1 1 83 0 0 1 1 83 0 0 1 1 83 0 0 1 1 83 0 0 1 1 83 0 0 1 1 83 0 0 1 1 
1 100 0 1 0 1 0 0 0 0 2 0 0 0 0 1 0 0 0 0 2 0 0 0 0 2 0 0 0 0 1 0 0 0 0 1 0 0 0 0 17 7 0 0 0 16 0 0 0 0 17 8 0 0 0 1 0 0 0 0 1 0 0 0 0 1 0 0 0 0 2 0 0 0 0 1 110 0 0 0 83 0 0 1 1 83 0 0 1 1 83 0 0 1 1 83 0 0 1 1 83 0 0 1 1 83 0 0 1 1 83 0 0 1 1 83 0 0 1 1 83 0 0 1 1 83 0 0 1 1 83 0 0 1 1 1 106 0 0 0 2 107 0 0 0 1 107 0 0 0 1 107 0 0 0 1 107 0 0 0 3 107 0 0 0 1 107 0 0 0 2 107 0 0 0 68 0 0 0 0 68 0 0 0 0 68 0 0 0 0 1 107 0 0 0 1 107 0 0 0 1 107 0 0 0 1 107 0 0 0 1 107 0 0 0 1 107 0 0 0 2 107 0 0 0 1 107 0 0 0 1 107 0 0 0 1 107 0 0 0 1 107 0 0 0 1 107 0 0 0 2 107 0 0 0 1 107 0 0 0 1 107 0 0 0 1 107 0 0 0 1 107 0 0 0 1 107 0 0 0 1 107 0 0 0 1 107 0 0 0 1 107 0 0 0 1 107 0 1 0 
1 100 0 1 0 2 0 0 0 0 1 0 0 0 0 1 0 0 0 0 1 0 0 0 0 1 0 0 0 0 2 0 0 0 0 1 0 0 0 0 17 7 0 0 0 16 0 0 0 0 17 8 0 0 0 1 0 0 0 0 2 0 0 0 0 1 0 0 0 0 2 0 0 0 0 1 0 0 0 0 1 107 0 0 0 2 107 0 0 0 1 108 0 0 0 83 0 0 1 1 83 0 0 1 1 83 0 0 1 1 83 0 0 1 1 1 106 0 0 0 1 107 0 0 0 1 107 0 0 0 1 107 0 0 0 1 0 0 0 0 2 0 0 0 0 1 0 0 0 0 1 0 0 0 0 3 0 0 0 0 1 0 0 0 0 1 0 0 0 0 1 0 0 0 0 16 7 0 0 0 16 0 0 0 0 16 8 0 0 0 2 0 0 0 0 1 0 0 0 0 2 0 0 0 0 1 0 0 0 0 1 0 0 0 0 1 0 0 0 0 2 0 0 0 0 1 0 0 0 0 1 0 0 0 0 2 0 0 0 0 1 0 0 0 0 1 0 0 0 0 1 0 0 0 0 91 0 0 1 0 1 0 0 0 0 88 0 0 1 0 1 112 0 0 0 1 117 0 1 0 1 0 0 0 0 1 0 0 0 0 3 0 0 0 0 1 100 0 1 0 
1 100 0 1 0 1 0 0 0 0 1 0 0 0 0 1 0 0 0 0 1 0 0 0 0 1 0 0 0 0 1 0 0 0 0 1 0 0 0 0 17 7 0 0 0 16 0 0 0 0 17 8 0 0 0 1 0 0 0 0 1 0 0 0 0 1 0 0 0 0 1 0 0 0 0 1 0 0 0 0 3 0 0 0 0 1 0 0 0 0 1 0 0 0 0 1 107 0 0 0 1 107 0 0 0 1 107 0 0 0 1 107 0 0 0 2 0 0 0 0 3 0 0 0 0 2 0 0 0 0 1 0 0 0 0 2 0 0 0 0 1 0 0 0 0 1 0 0 0 0 1 0 0 0 0 1 0 0 0 0 1 0 0 0 0 2 0 0 0 0 2 0 0 0 0 16 7 0 0 0 17 0 0 0 0 17 8 0 0 0 1 0 0 0 0 1 0 0 0 0 1 0 0 0 0 1 0 0 0 0 2 0 0 0 0 2 0 0 0 0 1 0 0 0 0 1 0 0 0 0 1 112 0 0 0 1 112 0 0 0 88 0 0 1 0 88 0 0 1 0 88 0 0 1 0 89 0 0 1 0 1 24 0 0 0 96 0 0 0 0 96 0 0 0 0 1 111 0 0 0 2 0 0 0 0 2 0 0 0 0 1 0 0 0 0 2 100 0 1 0 
1 100 0 1 0 1 0 0 0 0 1 0 0 0 0 2 0 0 0 0 2 0 0 0 0 2 0 0 0 0 1 0 0 0 0 1 0 0 0 0 16 7 0 0 0 16 0 0 0 0 16 8 0 0 0 2 0 0 0 0 1 0 0 0 0 1 0 0 0 0 2 0 0 0 0 1 79 0 0 0 1 0 0 0 0 1 0 0 0 0 1 0 0 0 0 2 0 0 0 0 1 0 0 0 0 1 0 0 0 0 2 0 0 0 0 1 0 0 0 0 1 0 0 0 0 1 0 0 0 0 1 0 0 0 0 1 0 0 0 0 1 0 0 0 0 3 0 0 0 0 1 0 0 0 0 1 0 0 0 0 2 0 0 0 0 1 0 0 0 0 1 0 0 0 0 17 7 0 0 0 18 0 0 0 0 16 8 0 0 0 1 0 0 0 0 1 0 0 0 0 2 0 0 0 0 1 0 0 0 0 1 0 0 0 0 1 0 0 0 0 2 0 0 0 0 1 110 0 0 0 96 0 0 0 0 96 0 0 0 0 96 117 0 1 0 96 133 0 1 0 96 0 0 0 0 96 0 0 0 0 1 27 0 0 0 96 0 0 0 0 96 0 0 0 0 96 0 0 0 0 1 109 0 0 0 1 0 0 0 0 1 0 0 0 0 1 119 0 1 0 
1 100 0 1 0 1 0 0 0 0 1 0 0 0 0 1 0 0 0 0 1 0 0 0 0 1 0 0 0 0 1 0 0 0 0 1 0 0 0 0 17 7 0 0 0 16 0 0 0 0 16 8 0 0 0 1 0 0 0 0 2 0 0 0 0 1 0 0 0 0 1 0 0 0 0 2 0 0 0 0 1 0 0 0 0 2 0 0 0 0 1 0 0 0 0 2 0 0 0 0 1 0 0 0 0 3 0 0 0 0 1 0 0 0 0 1 0 0 0 0 1 117 0 1 0 2 0 0 0 0 1 0 0 0 0 1 0 0 0 0 2 0 0 0 0 1 0 0 0 0 1 0 0 0 0 2 0 0 0 0 1 0 0 0 0 1 0 0 0 0 1 0 0 0 0 17 7 0 0 0 16 0 0 0 0 16 8 0 0 0 1 0 0 0 0 1 0 0 0 0 1 0 0 0 0 1 0 0 0 0 2 0 0 0 0 3 0 0 0 0 1 0 0 0 0 91 0 0 1 0 96 0 0 0 0 96 0 0 0 0 96 0 0 0 0 96 0 0 0 0 96 0 0 0 0 96 0 0 0 0 96 0 0 0 0 96 0 0 0 0 1 25 0 0 0 96 0 0 0 0 91 0 0 1 0 1 117 0 1 0 1 0 0 0 0 2 100 0 1 0 
1 100 0 1 0 1 0 0 0 0 80 0 0 0 0 1 0 0 0 0 1 0 0 0 0 2 0 0 0 0 1 0 0 0 0 1 0 0 0 0 16 7 0 0 0 17 0 0 0 0 16 8 0 0 0 1 0 0 0 0 1 0 0 0 0 80 0 0 0 0 1 0 0 0 0 1 0 0 0 0 1 0 0 0 0 1 0 0 0 0 1 0 0 0 0 1 0 0 0 0 1 0 0 0 0 1 0 0 0 0 2 0 0 0 0 1 0 0 0 0 1 0 0 0 0 1 0 0 0 0 1 0 0 0 0 2 0 0 0 0 1 0 0 0 0 1 0 0 0 0 3 0 0 0 0 1 0 0 0 0 1 0 0 0 0 2 0 0 0 0 1 0 0 0 0 16 7 0 0 0 16 0 0 0 0 16 8 0 0 0 2 0 0 0 0 1 0 0 0 0 2 0 0 0 0 1 0 0 0 0 1 0 0 0 0 1 0 0 0 0 1 0 0 0 0 89 0 0 1 0 96 0 0 0 0 96 0 0 0 0 96 0 0 0 0 96 0 0 0 0 96 0 0 0 0 96 0 0 0 0 96 0 0 0 0 96 0 0 0 0 1 27 0 0 0 96 0 0 0 0 90 0 0 1 0 2 0 0 0 0 1 133 0 1 0 2 100 0 1 0 
1 100 0 1 0 1 0 0 0 0 1 0 0 0 0 1 0 0 0 0 1 0 0 0 0 1 0 0 0 0 1 0 0 0 0 1 0 0 0 0 16 7 0 0 0 16 0 0 0 0 16 14 0 0 0 16 5 0 0 0 16 5 0 0 0 16 5 0 0 0 16 5 0 0 0 16 5 0 0 0 16 5 0 0 0 16 5 0 0 0 17 5 0 0 0 17 5 0 0 0 18 5 0 0 0 16 5 0 0 0 17 5 0 0 0 16 5 0 0 0 16 5 0 0 0 16 5 0 0 0 16 5 0 0 0 16 5 0 0 0 17 5 0 0 0 16 5 0 0 0 16 5 0 0 0 17 5 0 0 0 17 5 0 0 0 16 5 0 0 0 16 5 0 0 0 17 15 0 0 0 17 0 0 0 0 16 8 0 0 0 2 0 0 0 0 1 0 0 0 0 1 0 0 0 0 1 0 0 0 0 3 0 0 0 0 1 0 0 0 0 1 0 0 0 0 2 110 0 0 0 96 0 0 0 0 96 0 0 0 0 96 0 0 0 0 96 0 0 0 0 96 0 0 0 0 96 0 0 0 0 96 0 0 0 0 1 29 0 0 0 96 0 0 0 0 96 0 0 0 0 90 0 0 1 0 2 0 0 0 0 3 0 0 0 0 1 100 0 1 0 
1 100 0 1 0 1 0 0 0 0 1 0 0 0 0 1 79 0 0 0 1 0 0 0 0 2 0 0 0 0 1 0 0 0 0 1 0 0 0 0 16 7 0 0 0 16 0 0 0 0 16 0 0 0 0 16 0 0 0 0 18 0 0 0 0 16 0 0 0 0 16 0 0 0 0 16 0 0 0 0 16 0 0 0 0 17 0 0 0 0 17 0 0 0 0 16 0 0 0 0 17 0 0 0 0 16 0 0 0 0 17 0 0 0 0 17 0 0 0 0 16 0 0 0 0 17 0 0 0 0 17 0 0 0 0 17 0 0 0 0 17 0 0 0 0 16 0 0 0 0 18 0 0 0 0 16 0 0 0 0 17 0 0 0 0 17 0 0 0 0 16 0 0 0 0 17 0 0 0 0 17 0 0 0 0 16 8 0 0 0 1 0 0 0 0 1 131 0 1 0 1 0 0 0 0 1 178 0 1 0 2 0 0 0 0 1 0 0 0 0 1 0 0 0 0 1 110 0 0 0 96 0 0 0 0 1 29 0 0 0 96 0 0 0 0 96 0 0 0 0 96 0 0 0 0 96 0 0 0 0 96 0 0 0 0 96 117 0 1 0 96 0 0 0 0 96 0 0 0 0 90 0 0 1 0 1 117 0 1 0 1 0 0 0 0 1 100 0 1 0 
1 100 0 1 0 1 0 0 0 0 1 0 0 0 0 2 0 0 0 0 1 0 0 0 0 1 0 0 0 0 1 0 0 0 0 2 0 0 0 0 16 9 0 0 0 16 10 0 0 0 16 10 0 0 0 16 10 0 0 0 16 10 0 0 0 16 10 0 0 0 16 10 0 0 0 16 10 0 0 0 17 10 0 0 0 17 10 0 0 0 16 10 0 0 0 16 10 0 0 0 17 10 0 0 0 16 10 0 0 0 16 10 0 0 0 17 10 0 0 0 17 10 0 0 0 17 10 0 0 0 16 10 0 0 0 16 10 0 0 0 16 10 0 0 0 18 10 0 0 0 16 10 0 0 0 16 10 0 0 0 16 10 0 0 0 17 10 0 0 0 16 10 0 0 0 16 10 0 0 0 17 10 0 0 0 16 11 0 0 0 1 0 0 0 0 1 186 0 0 0 1 183 0 0 0 1 183 0 0 0 1 183 0 0 0 1 187 0 0 0 1 0 0 0 0 91 0 0 1 0 1 108 0 0 0 96 0 0 0 0 96 0 0 0 0 1 28 0 0 0 1 26 0 0 0 96 0 0 0 0 1 29 0 0 0 96 0 0 0 0 96 0 0 0 0 96 0 0 0 0 89 0 0 1 0 1 0 0 0 0 1 0 0 0 0 2 100 0 1 0 
1 100 0 1 0 1 0 0 0 0 1 0 0 0 0 1 0 0 0 0 1 0 0 0 0 1 0 0 0 0 1 0 0 0 0 1 0 0 0 0 1 0 0 0 0 1 0 0 0 0 80 0 0 0 0 1 0 0 0 0 1 0 0 0 0 1 0 0 0 0 2 0 0 0 0 1 0 0 0 0 2 0 0 0 0 1 0 0 0 0 2 0 0 0 0 1 0 0 0 0 3 0 0 0 0 1 0 0 0 0 1 0 0 0 0 1 0 0 0 0 1 0 0 0 0 1 0 0 0 0 1 0 0 0 0 1 0 0 0 0 1 0 0 0 0 2 0 0 0 0 1 0 0 0 0 2 0 0 0 0 1 0 0 0 0 2 0 0 0 0 1 0 0 0 0 2 0 0 0 0 1 0 0 0 0 1 0 0 0 0 1 0 0 0 0 1 178 0 1 0 1 0 0 0 0 1 178 0 1 0 1 0 0 0 0 1 178 0 1 0 1 133 0 1 0 90 0 0 1 0 1 110 0 0 0 96 0 0 0 0 96 0 0 0 0 96 0 0 0 0 96 0 0 0 0 96 0 0 0 0 96 0 0 0 0 96 0 0 0 0 96 0 0 0 0 96 0 0 0 0 1 109 0 0 0 2 0 0 0 0 1 0 0 0 0 2 100 0 1 0 
1 100 0 1 0 1 0 0 0 0 2 0 0 0 0 1 0 0 0 0 1 0 0 0 0 2 0 0 0 0 1 0 0 0 0 2 0 0 0 0 1 0 0 0 0 1 0 0 0 0 2 0 0 0 0 2 0 0 0 0 1 0 0 0 0 2 0 0 0 0 1 0 0 0 0 1 0 0 0 0 1 0 0 0 0 1 0 0 0 0 1 0 0 0 0 1 0 0 0 0 1 0 0 0 0 1 0 0 0 0 1 0 0 0 0 1 0 0 0 0 1 0 0 0 0 1 0 0 0 0 2 0 0 0 0 1 0 0 0 0 1 0 0 0 0 1 0 0 0 0 1 0 0 0 0 1 0 0 0 0 1 0 0 0 0 1 0 0 0 0 1 0 0 0 0 2 0 0 0 0 1 0 0 0 0 3 0 0 0 0 1 0 0 0 0 1 186 0 0 0 1 183 0 0 0 1 183 0 0 0 1 183 0 0 0 1 187 0 0 0 1 0 0 0 0 89 0 0 1 0 1 0 0 0 0 1 107 0 0 0 88 0 0 1 0 88 0 0 1 0 88 0 0 1 0 96 0 0 0 0 88 0 0 1 0 88 0 0 1 0 88 0 0 1 0 88 0 0 1 0 88 0 0 1 0 1 0 0 0 0 1 0 0 0 0 1 100 0 1 0 
1 100 0 1 0 2 0 0 0 0 1 0 0 0 0 1 0 0 0 0 1 0 0 0 0 1 0 0 0 0 2 0 0 0 0 1 0 0 0 0 1 0 0 0 0 1 0 0 0 0 1 0 0 0 0 2 0 0 0 0 2 0 0 0 0 1 0 0 0 0 1 0 0 0 0 1 0 0 0 0 2 0 0 0 0 1 79 0 0 0 1 0 0 0 0 2 0 0 0 0 2 0 0 0 0 1 0 0 0 0 1 0 0 0 0 1 0 0 0 0 1 0 0 0 0 1 0 0 0 0 1 0 0 0 0 3 0 0 0 0 2 0 0 0 0 1 0 0 0 0 1 0 0 0 0 1 0 0 0 0 1 0 0 0 0 1 0 0 0 0 2 0 0 0 0 1 0 0 0 0 1 0 0 0 0 1 0 0 0 0 1 0 0 0 0 1 178 0 1 0 1 0 0 0 0 1 178 0 1 0 1 0 0 0 0 1 132 0 1 0 1 0 0 0 0 1 0 0 0 0 1 0 0 0 0 1 0 0 0 0 1 0 0 0 0 2 0 0 0 0 1 0 0 0 0 1 107 0 0 0 3 0 0 0 0 1 0 0 0 0 1 0 0 0 0 1 133 0 1 0 1 132 0 1 0 1 0 0 0 0 3 0 0 0 0 1 119 0 1 0 
1 100 0 1 0 1 0 0 0 0 1 0 0 0 0 1 0 0 0 0 1 0 0 0 0 1 0 0 0 0 1 0 0 0 0 1 0 0 0 0 1 0 0 0 0 2 0 0 0 0 1 0 0 0 0 1 0 0 0 0 1 0 0 0 0 1 0 0 0 0 1 0 0 0 0 2 0 0 0 0 1 0 0 0 0 1 0 0 0 0 1 0 0 0 0 1 0 0 0 0 2 0 0 0 0 1 0 0 0 0 1 100 0 1 0 1 100 0 1 0 1 0 0 0 0 1 0 0 0 0 1 0 0 0 0 1 0 0 0 0 1 0 0 0 0 1 100 0 1 0 1 100 0 1 0 1 119 0 1 0 2 0 0 0 0 1 0 0 0 0 1 0 0 0 0 1 0 0 0 0 1 0 0 0 0 1 0 0 0 0 1 0 0 0 0 1 186 0 0 0 1 183 0 0 0 1 183 0 0 0 1 183 0 0 0 1 187 0 0 0 2 0 0 0 0 1 0 0 0 0 3 0 0 0 0 1 0 0 0 0 1 0 0 0 0 2 0 0 0 0 1 0 0 0 0 1 0 0 0 0 1 0 0 0 0 2 0 0 0 0 1 0 0 0 0 2 0 0 0 0 1 0 0 0 0 1 0 0 0 0 1 0 0 0 0 2 100 0 1 0 
1 100 0 1 0 1 100 0 1 0 1 100 0 1 0 1 100 0 1 0 1 100 0 1 0 1 100 0 1 0 1 100 0 1 0 1 100 0 1 0 1 100 0 1 0 1 100 0 1 0 1 100 0 1 0 1 100 0 1 0 1 100 0 1 0 1 100 0 1 0 1 100 0 1 0 1 100 0 1 0 1 100 0 1 0 1 100 0 1 0 1 100 0 1 0 1 100 0 1 0 1 100 0 1 0 1 100 0 1 0 1 100 0 1 0 1 100 0 1 0 1 100 0 1 0 2 100 0 1 0 1 100 0 1 0 1 100 0 1 0 1 100 0 1 0 1 100 0 1 0 1 100 0 1 0 1 100 0 1 0 1 100 0 1 0 1 100 0 1 0 1 100 0 1 0 2 100 0 1 0 2 100 0 1 0 2 119 0 1 0 2 100 0 1 0 1 100 0 1 0 2 100 0 1 0 2 100 0 1 0 2 100 0 1 0 2 100 0 1 0 1 100 0 1 0 1 119 0 1 0 2 100 0 1 0 2 100 0 1 0 2 100 0 1 0 2 100 0 1 0 2 100 0 1 0 2 100 0 1 0 1 100 0 1 0 1 100 0 1 0 2 119 0 1 0 1 100 0 1 0 1 100 0 1 0 2 100 0 1 0 1 100 0 1 0 2 119 0 1 0 