20 20
87 0 0 0 0 87 0 0 0 0 87 0 0 0 0 87 0 0 0 0 87 0 0 0 0 87 0 0 0 0 87 0 0 0 0 87 0 0 0 0 87 0 0 0 0 87 0 0 0 0 87 0 0 0 0 87 0 0 0 0 87 0 0 0 0 87 0 0 0 0 87 0 0 0 0 87 0 0 0 0 87 0 0 0 0 87 0 0 0 0 87 0 0 0 0 87 0 0 0 0 
87 0 0 0 0 330 0 0 0 0 331 0 0 0 0 87 0 0 0 0 87 0 0 0 0 87 0 0 0 0 87 0 0 0 0 332 0 0 0 0 87 0 0 0 0 87 0 0 0 0 87 0 0 0 0 87 0 0 0 0 87 0 0 0 0 87 0 0 0 0 87 0 0 0 0 87 0 0 0 0 87 0 0 0 0 87 0 0 0 0 87 0 0 0 0 87 0 0 0 0 
87 0 0 0 0 340 0 0 0 0 341 0 0 0 0 87 0 0 0 0 87 0 0 0 0 87 0 0 0 0 87 0 0 0 0 87 0 0 0 0 87 0 0 0 0 87 0 0 0 0 87 0 0 0 0 87 0 0 0 0 87 0 0 0 0 87 0 0 0 0 87 0 0 0 0 87 0 0 0 0 87 0 0 0 0 87 0 0 0 0 87 0 0 0 0 87 0 0 0 0 
87 0 0 0 0 87 0 0 0 0 87 0 0 0 0 87 0 0 0 0 87 0 0 0 0 87 0 0 0 0 87 0 0 0 0 87 0 0 0 0 87 0 0 0 0 87 0 0 0 0 87 0 0 0 0 87 0 0 0 0 87 0 0 0 0 87 0 0 0 0 87 0 0 0 0 87 0 0 0 0 87 0 0 0 0 87 0 0 0 0 87 0 0 0 0 87 0 0 0 0 
87 0 0 0 0 87 0 0 0 0 87 0 0 0 0 87 0 0 0 0 87 0 0 0 0 87 0 0 1 0 87 0 0 1 0 87 0 0 1 0 87 0 0 1 0 87 0 0 1 0 87 0 0 0 0 87 0 0 0 0 87 0 0 0 0 333 0 0 0 0 87 0 0 0 0 87 0 0 0 0 87 91 0 1 0 88 0 0 1 0 88 0 0 1 0 88 0 0 1 0 
87 0 0 0 0 87 0 0 0 0 87 0 0 0 0 87 0 0 0 0 87 0 0 0 0 87 0 0 1 0 324 0 0 0 0 325 0 0 0 0 326 0 0 0 0 87 88 0 1 0 87 88 0 1 0 87 88 0 1 0 87 88 0 1 0 87 88 0 1 0 87 88 0 1 0 87 88 0 1 0 87 89 0 1 0 96 0 0 0 0 96 0 0 0 0 96 0 0 0 0 
87 0 0 0 0 87 0 0 0 0 87 0 0 0 0 87 0 0 0 0 87 0 0 0 0 87 0 0 1 0 334 0 0 0 0 335 0 0 0 0 336 0 0 0 0 87 96 0 0 0 87 96 0 0 0 87 96 0 0 0 87 96 0 0 0 87 96 0 0 0 87 96 0 0 0 87 96 0 0 0 87 96 0 0 0 96 0 0 0 0 96 0 0 0 0 96 0 0 0 0 
87 0 0 0 0 87 0 0 0 0 87 0 0 0 0 87 0 0 0 0 87 0 0 0 0 87 0 0 1 0 344 0 0 0 0 345 0 0 0 0 346 0 0 0 0 96 0 0 0 0 96 0 0 0 0 96 0 0 0 0 96 0 0 0 0 96 0 0 0 0 96 0 0 0 0 96 0 0 0 0 96 0 0 0 0 96 0 0 0 0 96 0 0 0 0 96 0 0 0 0 
87 0 0 0 0 87 0 0 0 0 87 0 0 0 0 87 0 0 0 0 87 0 0 0 0 87 0 0 1 0 87 0 0 1 0 87 0 0 1 0 87 0 0 1 0 88 0 0 1 0 88 0 0 1 0 88 0 0 1 0 88 0 0 1 0 88 0 0 1 0 88 0 0 1 0 88 0 0 1 0 88 0 0 1 0 91 0 0 1 0 96 0 0 0 0 96 0 0 0 0 
87 0 0 0 0 87 0 0 0 0 87 0 0 0 0 87 0 0 0 0 87 0 0 0 0 87 0 0 0 0 87 0 0 0 0 347 0 0 0 0 87 0 0 0 0 98 0 0 0 0 98 0 0 0 0 98 0 0 0 0 98 0 0 0 0 98 0 0 0 0 98 0 0 0 0 98 0 0 0 0 98 0 0 0 0 90 0 0 1 0 96 0 0 0 0 96 0 0 0 0 
87 0 0 0 0 87 0 0 0 0 87 0 0 0 0 87 0 0 0 0 87 0 0 0 0 87 0 0 0 0 333 0 0 0 0 87 0 0 0 0 87 0 0 0 0 87 0 0 0 0 87 0 0 0 0 87 0 0 0 0 87 0 0 0 0 87 0 0 0 0 87 0 0 0 0 87 0 0 0 0 87 0 0 0 0 90 0 0 1 0 96 0 0 0 0 96 0 0 0 0 
87 0 0 0 0 87 0 0 0 0 87 0 0 0 0 87 0 0 0 0 87 0 0 0 0 87 0 0 0 0 87 0 0 0 0 87 0 0 0 0 87 0 0 0 0 87 0 0 0 0 87 0 0 0 0 87 0 0 0 0 87 0 0 0 0 87 0 0 0 0 87 0 0 0 0 87 0 0 0 0 87 0 0 0 0 89 0 0 1 0 88 0 0 1 0 88 0 0 1 0 
87 0 0 0 0 87 0 0 0 0 87 0 0 0 0 87 0 0 0 0 87 0 0 0 0 87 0 0 0 0 87 0 0 0 0 87 0 0 0 0 87 0 0 0 0 87 0 0 0 0 87 0 0 0 0 87 0 0 0 0 87 0 0 0 0 87 0 0 0 0 87 0 0 0 0 87 0 0 0 0 87 0 0 0 0 98 0 0 0 0 98 0 0 0 0 98 0 0 0 0 
87 0 0 0 0 87 0 0 0 0 87 0 0 0 0 87 0 0 0 0 87 0 0 0 0 87 0 0 0 0 87 0 0 0 0 87 0 0 0 0 87 0 0 0 0 87 0 0 0 0 87 0 0 0 0 87 0 0 0 0 87 0 0 0 0 87 0 0 0 0 87 0 0 0 0 87 0 0 0 0 87 0 0 0 0 87 0 0 0 0 87 0 0 0 0 87 0 0 0 0 
87 0 0 0 0 87 0 0 0 0 87 0 0 0 0 87 0 0 0 0 87 0 0 0 0 87 0 0 0 0 87 0 0 0 0 87 0 0 0 0 87 0 0 0 0 87 0 0 0 0 87 0 0 0 0 87 0 0 0 0 87 0 0 0 0 87 0 0 0 0 87 0 0 0 0 87 0 0 0 0 87 0 0 0 0 87 0 0 0 0 87 0 0 0 0 87 0 0 0 0 
87 0 0 0 0 87 0 0 0 0 87 0 0 0 0 87 0 0 0 0 87 0 0 0 0 87 0 0 0 0 87 0 0 0 0 87 0 0 0 0 87 0 0 0 0 87 0 0 0 0 87 0 0 0 0 87 0 0 0 0 87 0 0 0 0 87 0 0 0 0 87 0 0 0 0 87 0 0 0 0 87 0 0 0 0 87 0 0 0 0 87 0 0 0 0 87 0 0 0 0 
87 0 0 0 0 87 0 0 0 0 87 0 0 0 0 87 0 0 0 0 87 0 0 0 0 87 0 0 0 0 87 0 0 0 0 87 0 0 0 0 87 0 0 0 0 87 0 0 0 0 87 0 0 0 0 87 0 0 0 0 87 0 0 0 0 87 0 0 0 0 87 0 0 0 0 87 0 0 0 0 87 0 0 0 0 87 0 0 0 0 87 0 0 0 0 87 0 0 0 0 
87 0 0 0 0 87 0 0 0 0 87 0 0 0 0 87 0 0 0 0 87 0 0 0 0 87 0 0 0 0 87 0 0 0 0 87 0 0 0 0 87 0 0 0 0 87 0 0 0 0 87 0 0 0 0 87 0 0 0 0 87 0 0 0 0 87 0 0 0 0 87 0 0 0 0 87 0 0 0 0 87 0 0 0 0 87 0 0 0 0 87 0 0 0 0 87 0 0 0 0 
87 0 0 0 0 87 0 0 0 0 87 0 0 0 0 87 0 0 0 0 87 0 0 0 0 87 0 0 0 0 87 0 0 0 0 87 0 0 0 0 87 0 0 0 0 87 0 0 0 0 87 0 0 0 0 87 0 0 0 0 87 0 0 0 0 87 0 0 0 0 87 0 0 0 0 87 0 0 0 0 87 0 0 0 0 87 0 0 0 0 87 0 0 0 0 87 0 0 0 0 
87 0 0 0 0 87 0 0 0 0 87 0 0 0 0 87 0 0 0 0 87 0 0 0 0 87 0 0 0 0 87 0 0 0 0 87 0 0 0 0 87 0 0 0 0 87 0 0 0 0 87 0 0 0 0 87 0 0 0 0 87 0 0 0 0 87 0 0 0 0 87 0 0 0 0 87 0 0 0 0 87 0 0 0 0 87 0 0 0 0 87 0 0 0 0 87 0 0 0 0 