25 20
1 112 0 0 0 1 112 0 0 0 3 0 0 0 0 1 0 0 0 0 1 100 0 1 0 2 0 0 0 0 1 0 0 0 0 1 100 0 1 0 2 0 0 0 0 1 112 0 0 0 1 113 0 0 0 97 0 0 1 0 1 100 0 1 0 16 7 100 1 0 16 115 0 1 0 17 115 0 1 0 16 115 0 1 0 224 0 0 1 0 225 0 0 1 0 225 0 0 1 0 225 0 0 1 0 226 0 0 1 0 16 115 0 1 0 16 115 0 1 0 17 115 0 1 0 
97 0 0 1 0 97 0 0 1 0 1 111 0 0 0 1 0 0 0 0 2 0 0 0 0 1 0 0 0 0 3 0 0 0 0 1 0 0 0 0 1 113 0 0 0 97 0 0 1 0 97 0 0 1 0 1 106 0 0 0 1 0 0 0 0 16 7 0 0 0 16 0 0 0 0 16 0 0 0 0 16 0 0 0 0 234 0 0 1 0 235 0 0 1 0 235 147 0 1 0 235 0 0 1 0 236 0 0 1 0 17 0 0 0 0 16 0 0 0 0 17 116 0 1 0 
1 107 100 1 0 1 108 0 0 0 97 0 0 1 0 1 111 0 0 0 1 112 0 0 0 1 112 0 0 0 2 112 0 0 0 1 113 0 0 0 97 0 0 1 0 1 106 0 0 0 1 107 0 0 0 1 0 0 0 0 16 4 0 0 0 16 15 0 0 0 16 0 201 0 0 202 0 202 0 0 16 0 203 0 0 16 0 0 0 0 17 0 0 0 0 18 0 0 0 0 16 0 0 0 0 16 0 0 0 0 16 0 0 0 0 16 0 0 0 0 16 116 0 1 0 
1 101 0 1 0 1 0 0 0 0 1 108 0 0 0 97 0 0 1 0 97 0 0 1 0 97 0 0 1 0 97 0 0 1 0 97 0 0 1 0 1 106 0 0 0 1 0 0 0 0 1 0 0 0 0 16 4 0 0 0 16 15 0 0 0 16 0 0 0 0 211 0 0 1 0 212 0 0 1 0 213 0 0 1 0 16 0 0 0 0 16 0 0 0 0 16 0 207 0 0 16 0 208 0 0 18 0 208 0 0 16 0 209 0 0 16 0 0 0 0 16 116 0 1 0 
1 100 0 1 0 1 0 0 0 0 2 0 0 0 0 1 107 0 0 0 1 107 0 0 0 1 107 0 0 0 1 107 0 0 0 1 107 0 0 0 1 0 0 0 0 1 0 0 0 0 16 4 0 0 0 16 15 0 0 0 16 0 0 0 0 16 0 0 0 0 221 0 0 1 0 222 0 0 1 0 223 0 0 1 0 16 0 0 0 0 16 0 0 0 0 217 0 0 1 0 218 0 0 1 0 218 0 0 1 0 219 0 0 1 0 16 0 0 0 0 16 116 0 1 0 
1 100 0 1 0 1 0 0 0 0 1 0 0 0 0 1 0 0 0 0 1 0 0 0 0 1 0 0 0 0 1 0 0 0 0 1 0 0 0 0 16 4 0 0 0 16 5 0 0 0 17 15 0 0 0 17 0 0 0 0 16 0 0 0 0 16 0 0 0 0 231 0 0 1 0 232 154 0 1 0 233 156 0 1 0 18 0 0 0 0 16 0 0 0 0 227 0 0 1 0 228 0 0 1 0 228 170 0 1 0 229 0 0 1 0 16 0 0 0 0 16 116 0 1 0 
17 5 0 0 0 16 5 0 0 0 17 5 0 0 0 17 5 0 0 0 16 5 0 0 0 16 5 0 0 0 16 5 0 0 0 16 5 0 0 0 16 15 0 0 0 18 0 0 0 0 16 0 0 0 0 16 0 0 0 0 17 0 0 0 0 16 0 0 0 0 16 0 0 0 0 17 0 0 0 0 16 0 0 0 0 16 0 0 0 0 16 0 0 0 0 237 0 0 1 0 238 156 0 1 0 238 154 0 1 0 239 0 0 1 0 16 0 0 0 0 16 42 116 1 0 
16 0 0 0 0 16 0 0 0 0 17 0 0 0 0 16 0 0 0 0 16 0 0 0 0 16 0 0 0 0 16 0 0 0 0 16 0 0 0 0 16 0 0 0 0 16 0 0 0 0 16 0 0 0 0 16 0 0 0 0 16 0 0 0 0 16 0 0 0 0 16 0 0 0 0 16 0 0 0 0 17 0 0 0 0 16 0 0 0 0 16 0 0 0 0 16 0 0 0 0 17 0 0 0 0 17 0 0 0 0 16 0 0 0 0 16 0 0 0 0 16 38 116 1 0 
16 10 0 0 0 16 10 0 0 0 16 10 0 0 0 16 10 0 0 0 16 10 0 0 0 16 10 0 0 0 17 13 0 0 0 16 0 0 0 0 17 0 0 0 0 16 0 0 0 0 16 0 0 0 0 17 0 0 0 0 16 0 0 0 0 17 0 0 0 0 16 0 0 0 0 16 99 0 1 0 16 0 0 0 0 17 0 0 0 0 16 0 0 0 0 18 0 0 0 0 16 0 0 0 0 16 0 0 0 0 16 0 0 0 0 16 42 0 0 0 16 41 116 1 0 
1 100 0 1 0 1 0 0 0 0 1 0 0 0 0 1 100 0 1 0 1 0 0 0 0 1 0 0 0 0 16 9 0 0 0 16 10 0 0 0 16 10 0 0 0 16 13 0 0 0 16 0 0 0 0 16 0 0 0 0 16 0 0 0 0 17 0 0 0 0 16 0 0 0 0 16 0 0 0 0 16 0 0 0 0 16 0 0 0 0 16 0 0 0 0 16 0 0 0 0 16 0 0 0 0 16 42 0 0 0 16 40 0 0 0 16 41 0 0 0 31 116 0 1 0 
1 101 0 1 0 1 0 0 0 0 2 0 0 0 0 1 0 0 0 0 1 0 0 0 0 1 0 0 0 0 1 0 0 0 0 1 0 0 0 0 1 0 0 0 0 16 7 0 0 0 17 0 0 0 0 16 0 0 0 0 16 0 0 0 0 16 0 0 0 0 16 0 0 0 0 16 0 0 0 0 16 0 0 0 0 16 0 0 0 0 16 42 0 0 0 16 40 0 0 0 16 40 0 0 0 17 41 0 0 0 31 0 0 0 0 31 117 0 1 0 31 116 0 1 0 
1 100 0 1 0 1 0 0 0 0 1 0 0 0 0 1 0 0 0 0 2 0 0 0 0 1 0 0 0 0 1 0 0 0 0 1 0 0 0 0 1 0 0 0 0 16 9 0 0 0 17 10 0 0 0 16 13 0 0 0 16 0 0 0 0 16 0 0 0 0 16 0 0 0 0 16 0 0 0 0 16 0 0 0 0 17 0 0 0 0 16 38 0 0 0 31 32 0 0 0 31 0 0 0 0 31 0 0 0 0 31 81 0 0 0 31 32 0 0 0 31 116 0 1 0 
1 100 0 1 0 1 0 0 0 0 1 0 0 0 0 1 174 0 1 0 1 0 0 0 0 1 0 0 0 0 1 0 0 0 0 1 0 0 0 0 1 0 0 0 0 1 0 0 0 0 1 0 0 0 0 16 9 0 0 0 16 13 0 0 0 16 0 0 0 0 16 0 0 0 0 18 0 0 0 0 16 0 0 0 0 16 0 0 0 0 16 38 0 0 0 31 0 0 0 0 31 0 0 0 0 31 33 0 0 0 31 0 0 0 0 31 0 0 0 0 31 116 0 1 0 
1 100 0 1 0 1 0 0 0 0 1 0 0 0 0 1 0 0 0 0 1 0 0 0 0 1 100 0 1 0 2 0 0 0 0 1 115 0 1 0 1 115 0 1 0 1 115 0 1 0 1 115 0 1 0 1 115 0 1 0 16 9 0 0 0 16 13 0 0 0 16 0 0 0 0 16 0 0 0 0 16 0 0 0 0 16 0 0 0 0 16 44 0 0 0 16 36 0 0 0 31 0 0 0 0 31 0 0 0 0 31 0 0 0 0 31 32 0 0 0 31 116 0 1 0 
1 100 0 1 0 1 0 0 0 0 1 174 0 1 0 1 0 0 0 0 1 0 0 0 0 1 0 0 0 0 1 0 0 0 0 1 116 0 1 0 3 0 0 0 0 1 79 0 0 0 80 0 0 0 0 1 0 0 0 0 1 0 0 0 0 17 7 0 0 0 16 0 0 0 0 16 0 0 0 0 16 0 0 0 0 17 0 0 0 0 16 0 0 0 0 16 44 0 0 0 17 35 0 0 0 16 35 0 0 0 16 36 0 0 0 31 0 0 0 0 31 116 0 1 0 
1 101 0 1 0 2 0 0 0 0 1 0 0 0 0 1 101 0 1 0 2 0 0 0 0 1 0 0 0 0 1 0 0 0 0 1 116 0 1 0 1 79 0 0 0 80 0 0 0 0 1 79 0 0 0 2 116 0 1 0 1 0 0 0 0 16 9 0 0 0 16 10 0 0 0 16 13 0 0 0 17 0 0 0 0 16 0 0 0 0 16 0 0 0 0 18 0 0 0 0 17 0 0 0 0 16 0 0 0 0 16 44 0 0 0 17 35 0 0 0 16 35 116 1 0 
1 100 0 1 0 1 0 0 0 0 1 0 0 0 0 1 0 0 0 0 1 0 0 0 0 1 174 0 1 0 1 0 0 0 0 1 116 0 1 0 1 115 0 1 0 2 115 0 1 0 1 115 0 1 0 1 115 0 1 0 1 0 0 0 0 1 0 0 0 0 1 0 0 0 0 16 9 0 0 0 17 13 0 0 0 16 0 0 0 0 16 0 0 0 0 16 0 0 0 0 16 0 0 0 0 17 0 0 0 0 16 0 0 0 0 16 0 0 0 0 16 116 0 1 0 
1 100 0 1 0 1 0 0 0 0 1 100 0 1 0 1 0 0 0 0 1 0 0 0 0 1 0 0 0 0 1 0 0 0 0 1 100 0 1 0 1 0 0 0 0 1 0 0 0 0 1 0 0 0 0 1 0 0 0 0 1 0 0 0 0 1 174 0 1 0 1 0 0 0 0 1 0 0 0 0 16 9 0 0 0 16 10 0 0 0 16 10 0 0 0 17 10 0 0 0 16 10 0 0 0 16 10 0 0 0 16 10 0 0 0 16 13 0 0 0 16 116 0 1 0 
1 100 0 1 0 1 0 0 0 0 1 0 0 0 0 1 0 0 0 0 1 0 0 0 0 2 0 0 0 0 1 0 0 0 0 1 0 0 0 0 1 0 0 0 0 1 0 0 0 0 1 0 0 0 0 1 0 0 0 0 1 0 0 0 0 2 0 0 0 0 1 0 0 0 0 1 0 0 0 0 1 0 0 0 0 1 0 0 0 0 1 0 0 0 0 1 0 0 0 0 1 0 0 0 0 1 0 0 0 0 1 0 0 0 0 16 9 0 0 0 16 10 100 1 0 
1 100 0 1 0 1 100 0 1 0 1 101 0 1 0 1 100 0 1 0 1 101 0 1 0 1 100 0 1 0 1 100 0 1 0 1 100 0 1 0 1 100 0 1 0 1 101 0 1 0 1 100 0 1 0 1 101 0 1 0 1 100 0 1 0 1 100 0 1 0 1 100 0 1 0 1 100 0 1 0 1 100 0 1 0 1 101 0 1 0 1 100 0 1 0 1 100 0 1 0 1 100 0 1 0 1 100 0 1 0 1 101 0 1 0 1 100 0 1 0 1 100 0 1 0 